,Unnamed: 0,OBJECTID,SUM_POP100,SUM_HU100,SUM_TotPop,SUM_HispPo,SUM_NonHis,SUM_NHOneR,SUM_NH_Whi,SUM_NH_Bla,SUM_NH_AmI,SUM_NH_Asi,SUM_NH_Haw,SUM_NH_Oth,SUM_NH_2or,SUM_VAP_To,SUM_VAP_Hi,SUM_VAP_No,SUM_VAP_NH,SUM_VAP__1,SUM_VAP__2,SUM_VAP__3,SUM_VAP__4,SUM_VAP_Ha,SUM_VAP__5,SUM_VAP__6,SUM_TotHou,SUM_OccHU,SUM_Vacant,BG_ID,Median_House_Value,x,y,restaurant,bus_station,library,hospital,post_office
0,0,1,1167,303,1167,841,326,320,54,252,1,9,0,4,6,776,553,223,222,51,161,1,8,0,1,1,303,286,17,481576701011,90100.0,29.595886636703405,-95.46113510371318,49,3,4,3,6
1,1,2,1758,492,1758,1033,725,717,34,673,0,10,0,0,8,1184,660,524,522,31,483,0,8,0,0,2,492,467,25,481576701012,89900.0,29.59042526600645,-95.46284879118043,45,3,4,3,5
2,2,3,2577,779,2577,1040,1537,1525,44,1455,6,13,0,7,12,1656,657,999,992,36,939,3,10,0,4,7,779,693,86,481576701013,102500.0,29.58709202971396,-95.45133012419954,45,3,3,3,5
3,3,4,1272,339,1272,1024,248,244,50,189,1,0,0,4,4,831,650,181,180,46,133,1,0,0,0,1,339,318,21,481576701014,68100.0,29.59257319314634,-95.4590462188107,47,3,4,3,5
4,4,5,2270,739,2270,940,1330,1321,35,1258,2,24,0,2,9,1568,603,965,959,29,905,2,21,0,2,6,739,693,46,481576701021,81900.0,29.585072384369248,-95.46683236781976,42,3,4,3,5
5,5,6,1113,369,1113,230,883,878,12,857,0,4,0,5,5,767,145,622,618,10,601,0,4,0,3,4,369,352,17,481576701022,124800.0,29.58358036658662,-95.45856092760704,42,3,3,3,5
6,6,7,960,312,960,250,710,700,53,631,2,14,0,0,10,695,156,539,535,45,474,2,14,0,0,4,312,294,18,481576702001,101200.0,29.603229799624504,-95.48051705294878,30,6,3,1,3
7,7,8,1374,398,1374,958,416,402,110,266,5,19,0,2,14,977,642,335,332,106,201,5,19,0,1,3,398,380,18,481576702002,74800.0,29.600436016485165,-95.47109902931544,40,4,4,3,5
8,8,9,1515,492,1515,563,952,941,27,897,1,16,0,0,11,1087,354,733,725,23,685,1,16,0,0,8,492,466,26,481576702003,91200.0,29.59466814543626,-95.47071891122752,39,3,4,3,5
9,9,10,2682,788,2682,1040,1642,1633,36,1575,1,14,1,6,9,1843,637,1206,1200,31,1152,0,12,1,4,6,788,750,38,481576702004,95900.0,29.5952666989674,-95.47820382963492,25,4,3,1,3
10,10,11,1791,576,1791,423,1368,1365,27,1332,6,0,0,0,3,1237,264,973,970,21,946,3,0,0,0,3,576,550,26,481576702005,94400.0,29.586296312526677,-95.47667583344372,31,4,3,1,3
11,11,12,1831,596,1831,583,1248,1233,53,1161,0,16,0,3,15,1273,346,927,921,48,857,0,15,0,1,6,596,559,37,481576703001,95400.0,29.6048519837356,-95.4888812146594,31,4,3,1,3
12,12,13,1970,664,1970,267,1703,1664,26,1631,0,2,0,5,39,1460,158,1302,1283,19,1261,0,2,0,1,19,664,631,33,481576703002,98500.0,29.5897563570641,-95.48731627514974,19,4,3,1,3
13,13,14,1764,646,1764,163,1601,1588,23,1540,4,18,1,2,13,1193,92,1101,1098,17,1060,1,17,1,2,3,646,629,17,481576704001,117100.0,29.613191906891466,-95.50300763335515,63,5,3,1,5
14,14,15,1052,378,1052,148,904,894,7,883,0,0,0,4,10,757,97,660,654,6,648,0,0,0,0,6,378,349,29,481576704002,123400.0,29.605358215559384,-95.50378247000025,58,4,3,1,4
15,15,16,2242,793,2242,431,1811,1785,50,1719,3,7,0,6,26,1619,275,1344,1331,44,1274,3,7,0,3,13,793,736,57,481576704003,101200.0,29.604587610989512,-95.49637777929746,37,4,3,1,3
16,16,17,0,0,0,0,0,0,0,0,0,0,0,0,0,0,0,0,0,0,0,0,0,0,0,0,0,0,0,481576705001,111300.0,29.6026757209509,-95.508233192698,59,5,4,1,4
17,17,18,0,0,0,0,0,0,0,0,0,0,0,0,0,0,0,0,0,0,0,0,0,0,0,0,0,0,0,481576705002,102800.0,29.611446742926468,-95.50885543055252,66,5,3,1,5
18,18,19,1774,607,1774,130,1644,1625,45,1569,1,4,0,6,19,1312,71,1241,1234,38,1189,1,4,0,2,7,607,583,24,481576706011,111200.0,29.585269477744763,-95.5114955837416,49,4,4,1,4
19,19,20,1114,390,1114,107,1007,995,20,968,2,5,0,0,12,803,70,733,723,18,699,1,5,0,0,10,390,371,19,481576706013,113500.0,29.58763656358393,-95.51754247719133,56,3,4,1,4
20,20,21,351,120,351,48,303,301,3,295,0,3,0,0,2,232,32,200,199,3,193,0,3,0,0,1,120,115,5,481576706014,128000.0,29.59703317168768,-95.5067705230327,54,4,4,1,4
21,21,22,1907,652,1907,508,1399,1393,36,1323,8,16,0,10,6,1349,328,1021,1017,31,963,4,14,0,5,4,652,605,47,481576706021,92400.0,29.589596499921846,-95.4988585227477,30,4,3,1,3
22,22,23,1506,514,1506,125,1381,1367,38,1302,2,23,0,2,14,1064,77,987,982,36,923,2,20,0,1,5,514,487,27,481576707001,105500.0,29.57578742837153,-95.51473275555075,46,3,3,1,3
23,23,24,0,0,0,0,0,0,0,0,0,0,0,0,0,0,0,0,0,0,0,0,0,0,0,0,0,0,0,481576719001,149200.0,29.660526305256592,-95.59683139447138,128,6,6,8,4
24,24,25,2076,843,2076,699,1377,1323,359,439,5,510,1,9,54,1528,455,1073,1039,297,336,4,398,0,4,34,843,799,44,481576720013,95500.0,29.664257150028828,-95.61081903658884,129,6,5,6,3
25,26,27,115,30,115,12,103,99,0,62,0,37,0,0,4,83,8,75,71,0,40,0,31,0,0,4,30,30,0,481576724001,150700.0,29.677469412252417,-95.64219159807932,68,4,3,3,5
26,27,28,31,10,31,8,23,23,14,6,3,0,0,0,0,20,5,15,15,8,4,3,0,0,0,0,10,10,0,481576724002,115600.0,29.66712087699521,-95.62019442629634,121,6,4,5,5
27,30,31,9,3,9,7,2,2,0,2,0,0,0,0,0,6,4,2,2,0,2,0,0,0,0,0,3,3,0,481576726015,103500.0,29.70066585605988,-95.67285719582236,55,1,1,1,3
28,31,32,3,1,3,0,3,3,0,0,0,3,0,0,0,3,0,3,3,0,0,0,3,0,0,0,1,1,0,481576727011,164500.0,29.66637629662413,-95.64556323791132,95,3,3,5,2
29,32,33,6,3,6,5,1,1,0,0,0,1,0,0,0,4,3,1,1,0,0,0,1,0,0,0,3,3,0,481576727012,154000.0,29.67160469654393,-95.64699856105892,70,1,3,5,2
30,33,34,825,298,825,229,596,576,278,167,1,130,0,0,20,580,148,432,425,213,114,1,97,0,0,7,298,278,20,481576729001,166100.0,29.69517062878861,-95.760063062229,28,0,2,0,2
31,34,35,9,4,9,1,8,8,6,0,0,2,0,0,0,9,1,8,8,6,0,0,2,0,0,0,4,4,0,481576730012,284400.0,29.73845197664308,-95.7705800789902,150,2,3,5,8
32,35,36,480,143,480,85,395,379,285,18,0,74,0,2,16,293,49,244,235,179,9,0,46,0,1,9,143,139,4,481576730021,260400.0,29.722429683938216,-95.72854559938604,121,2,2,5,5
33,36,37,0,0,0,0,0,0,0,0,0,0,0,0,0,0,0,0,0,0,0,0,0,0,0,0,0,0,0,481576730022,195900.0,29.71223122430468,-95.70975507004144,67,2,2,1,4
34,37,38,0,0,0,0,0,0,0,0,0,0,0,0,0,0,0,0,0,0,0,0,0,0,0,0,0,0,0,481576730031,340200.0,29.71750261644668,-95.7691967149983,137,2,2,5,6
35,38,39,61,17,61,8,53,52,32,0,1,19,0,0,1,37,4,33,33,19,0,1,13,0,0,0,17,17,0,481576730032,223100.0,29.70518968729969,-95.76505493298356,57,1,2,1,4
36,39,40,479,256,479,109,370,365,288,24,0,52,1,0,5,329,58,271,269,219,15,0,34,1,0,2,256,210,46,481576731021,245600.0,29.727869279078693,-95.77459239389248,144,2,2,5,8
37,40,41,36,13,36,6,30,28,11,4,0,13,0,0,2,24,4,20,19,7,4,0,8,0,0,1,13,12,1,481576731022,275700.0,29.71205528844517,-95.7755635067809,96,1,2,2,4
38,41,42,0,0,0,0,0,0,0,0,0,0,0,0,0,0,0,0,0,0,0,0,0,0,0,0,0,0,0,481576734001,300800.0,29.691181684497813,-95.77280093468713,43,0,2,0,4
39,42,43,3031,778,3031,898,2133,2115,924,843,13,47,0,288,18,2964,882,2082,2065,899,822,13,43,0,288,17,778,546,232,482011000001,196200.0,29.757840051952574,-95.35714838215225,529,13,25,25,23
40,43,44,544,555,544,75,469,459,291,135,2,25,1,5,10,523,68,455,448,288,130,2,24,1,3,7,555,416,139,482011000002,,29.75184949617788,-95.36776499096555,538,13,25,25,25
41,44,45,1115,989,1115,97,1018,1007,867,69,7,62,0,2,11,1073,82,991,984,854,62,7,59,0,2,7,989,775,214,482011000003,239600.0,29.76210498396073,-95.3652220204487,550,14,26,25,25
42,45,46,9652,87,9652,1788,7864,7845,2893,4881,3,58,0,10,19,9469,1747,7722,7704,2839,4795,3,57,0,10,18,87,72,15,482012101001,,29.76706594111073,-95.35172232158268,508,14,22,24,20
43,46,47,986,349,986,868,118,115,9,94,3,2,1,6,3,670,580,90,90,7,75,3,2,1,2,0,349,282,67,482012104001,69100.0,29.78707026370765,-95.35360906622176,491,12,20,10,19
44,47,48,721,249,721,675,46,42,28,13,0,1,0,0,4,507,464,43,41,27,13,0,1,0,0,2,249,218,31,482012104002,79700.0,29.7825833079254,-95.36039890079051,505,12,23,17,22
45,48,49,2557,895,2557,1775,782,771,108,646,3,11,0,3,11,1629,1221,408,406,87,306,3,7,0,3,2,895,824,71,482012104003,98700.0,29.78635303320461,-95.3609560079124,502,12,22,12,21
46,49,50,1064,308,1064,707,357,350,187,151,3,9,0,0,7,837,502,335,329,173,145,3,8,0,0,6,308,269,39,482012104004,121700.0,29.78764249676246,-95.36759121201884,514,12,22,10,22
47,50,51,1399,486,1399,1317,82,80,55,24,0,1,0,0,2,1005,932,73,71,50,20,0,1,0,0,2,486,432,54,482012105001,89500.0,29.79737175781716,-95.3623141480079,472,13,15,7,21
48,51,52,1838,653,1838,1425,413,410,67,332,4,4,0,3,3,1291,963,328,326,56,261,4,4,0,1,2,653,560,93,482012105002,86700.0,29.795311280089567,-95.35335661728602,462,13,15,10,17
49,52,53,1645,554,1645,1354,291,287,103,179,2,1,0,2,4,1178,968,210,208,89,114,2,1,0,2,2,554,512,42,482012105003,90000.0,29.79388261087519,-95.3642487247248,483,13,18,10,21
50,53,54,859,323,859,685,174,171,154,11,3,3,0,0,3,632,476,156,153,142,5,3,3,0,0,3,323,295,28,482012106001,126000.0,29.81138848901132,-95.37003292550958,407,11,12,6,17
51,54,55,1243,605,1243,881,362,350,310,27,2,10,0,1,12,1011,683,328,319,282,25,2,9,0,1,9,605,519,86,482012106002,157000.0,29.810543670927714,-95.36157758941675,406,11,12,6,16
52,55,56,1714,675,1714,1442,272,260,214,29,3,9,1,4,12,1315,1068,247,237,192,28,3,9,1,4,10,675,635,40,482012106003,131100.0,29.80352512977992,-95.3614875876249,451,13,14,7,18
53,56,57,1681,656,1681,1370,311,308,257,29,6,14,0,2,3,1251,977,274,271,235,17,5,12,0,2,3,656,588,68,482012106004,129400.0,29.804866922075323,-95.369111207892,454,13,14,6,18
54,57,58,733,250,733,573,160,156,25,127,2,1,0,1,4,530,398,132,130,22,104,2,1,0,1,2,250,217,33,482012107001,100600.0,29.802334411328268,-95.35404701812892,444,12,13,7,17
55,58,59,959,330,959,701,258,252,34,215,0,1,2,0,6,662,465,197,194,25,166,0,1,2,0,3,330,292,38,482012107002,85000.0,29.80952520287971,-95.35285501792865,404,11,10,6,14
56,59,60,793,285,793,617,176,175,26,147,1,1,0,0,1,569,425,144,143,23,118,1,1,0,0,1,285,245,40,482012107003,80400.0,29.806580626149778,-95.35434669490206,421,12,13,6,15
57,60,61,1382,556,1382,730,652,649,36,608,0,0,0,5,3,954,434,520,517,25,491,0,0,0,1,3,556,460,96,482012108001,63900.0,29.79701085961989,-95.34499587876152,422,13,13,6,16
58,61,62,1371,550,1371,998,373,364,15,345,3,1,0,0,9,993,679,314,307,12,293,1,1,0,0,7,550,431,119,482012108002,65800.0,29.78101362916432,-95.34570699145716,465,13,20,16,18
59,62,63,983,438,983,257,726,721,28,672,2,19,0,0,5,760,159,601,598,26,552,2,18,0,0,3,438,351,87,482012109001,73500.0,29.803997978743023,-95.33418971655772,365,13,11,5,12
60,63,64,637,293,637,105,532,532,7,523,1,1,0,0,0,487,62,425,425,5,419,1,0,0,0,0,293,247,46,482012109002,49600.0,29.804402622044396,-95.3268744585624,317,12,11,4,10
61,64,65,856,382,856,215,641,634,9,605,1,14,0,5,7,641,133,508,503,7,486,1,6,0,3,5,382,328,54,482012110001,50100.0,29.79780736335872,-95.33629475803764,393,13,13,5,13
62,65,66,1183,511,1183,355,828,822,29,782,1,9,0,1,6,886,229,657,653,28,617,1,6,0,1,4,511,449,62,482012110002,32700.0,29.796511824841883,-95.3288321963882,348,13,14,7,11
63,66,67,1374,605,1374,467,907,902,21,872,3,0,5,1,5,1017,292,725,723,16,700,3,0,3,1,2,605,499,106,482012111001,37200.0,29.78552119753349,-95.33812671983917,434,13,19,12,15
64,67,68,788,290,788,438,350,346,8,338,0,0,0,0,4,529,272,257,253,7,246,0,0,0,0,4,290,240,50,482012111002,65000.0,29.791649001765453,-95.33416008796804,377,13,16,8,13
65,68,69,865,367,865,377,488,481,2,473,0,6,0,0,7,638,237,401,398,2,390,0,6,0,0,3,367,298,69,482012111003,62700.0,29.788570234122705,-95.32494777741216,314,13,19,8,11
66,69,70,802,286,802,656,146,144,2,142,0,0,0,0,2,579,466,113,112,2,110,0,0,0,0,1,286,248,38,482012111004,60300.0,29.788673161419634,-95.3293198816496,370,13,19,8,12
67,70,71,860,305,860,389,471,464,8,450,5,0,0,1,7,573,230,343,337,8,323,5,0,0,1,6,305,263,42,482012111005,69600.0,29.78266603174189,-95.33133978566184,377,13,20,15,12
68,71,72,1315,503,1315,829,486,479,11,457,9,2,0,0,7,887,513,374,367,7,350,8,2,0,0,7,503,406,97,482012111006,54500.0,29.7860714016169,-95.3333709066817,389,13,19,10,12
69,72,73,829,453,829,152,677,673,15,655,1,1,0,1,4,639,97,542,538,11,525,0,1,0,1,4,453,344,109,482012112001,75000.0,29.804716442837265,-95.32060138504468,267,12,13,3,8
70,73,74,1245,612,1245,330,915,909,5,892,3,7,1,1,6,895,188,707,701,5,688,3,3,1,1,6,612,488,124,482012112002,75800.0,29.79563972246753,-95.3201673484005,273,13,16,6,9
71,74,75,757,318,757,469,288,284,9,274,0,1,0,0,4,566,336,230,226,9,216,0,1,0,0,4,318,255,63,482012112003,55200.0,29.78971912379519,-95.32035794633605,288,13,21,7,10
72,75,76,766,439,766,177,589,584,26,556,2,0,0,0,5,596,116,480,476,26,448,2,0,0,0,4,439,372,67,482012113001,63900.0,29.7734534390271,-95.33084873906904,384,14,21,20,12
73,76,77,1423,603,1423,392,1031,1017,29,987,0,0,0,1,14,872,223,649,641,18,623,0,0,0,0,8,603,488,115,482012113002,,29.772571645562287,-95.33730703391666,445,14,21,20,14
74,77,78,1003,456,1003,268,735,730,45,680,0,0,0,5,5,762,175,587,584,44,535,0,0,0,5,3,456,335,121,482012113003,68000.0,29.776649286061463,-95.32024350832413,297,12,24,16,10
75,78,79,1086,525,1086,315,771,768,5,762,0,0,0,1,3,797,204,593,591,4,586,0,0,0,1,2,525,397,128,482012113004,43700.0,29.7786998038202,-95.33117020869447,381,12,20,18,12
76,79,80,768,362,768,249,519,512,8,499,1,0,1,3,7,550,150,400,397,8,386,1,0,1,1,3,362,266,96,482012113005,24000.0,29.78205556925648,-95.32072565140356,296,13,22,14,10
77,80,81,1088,459,1088,384,704,701,17,671,6,7,0,0,3,760,240,520,517,15,495,4,3,0,0,3,459,378,81,482012114001,71900.0,29.772171855491266,-95.32044702756497,302,14,23,18,10
78,81,82,1440,542,1440,339,1101,1096,49,1043,1,3,0,0,5,856,188,668,665,44,617,1,3,0,0,3,542,479,63,482012114002,96000.0,29.76424510138119,-95.3216084778567,308,14,23,21,11
79,82,83,1162,536,1162,587,575,565,222,272,5,60,5,1,10,910,408,502,496,212,224,2,55,2,1,6,536,459,77,482012114003,205700.0,29.76556289766408,-95.33545345617428,435,14,21,23,17
80,83,84,1216,359,1216,1183,33,33,23,10,0,0,0,0,0,840,821,19,19,14,5,0,0,0,0,0,359,322,37,482012115001,,29.762144824839343,-95.28951334089922,134,11,12,6,7
81,84,85,2190,687,2190,1862,328,321,84,220,5,9,2,1,7,1509,1256,253,247,65,170,4,5,2,1,6,687,631,56,482012115002,79900.0,29.76815327999116,-95.30940925770582,240,12,16,11,8
82,85,86,1703,527,1703,1613,90,87,84,2,1,0,0,0,3,1169,1100,69,66,63,2,1,0,0,0,3,527,463,64,482012115003,68000.0,29.766325996125552,-95.30052459849549,194,13,13,7,8
83,86,87,835,258,835,787,48,48,40,7,0,1,0,0,0,583,543,40,40,34,5,0,1,0,0,0,258,226,32,482012115004,84500.0,29.768174052055265,-95.29500587116254,162,12,12,5,8
84,87,88,963,285,963,918,45,45,39,2,0,1,0,3,0,632,598,34,34,30,2,0,1,0,1,0,285,256,29,482012115005,65000.0,29.774890739999588,-95.29204186555648,130,10,12,5,7
85,88,89,1139,580,1139,978,161,160,42,116,2,0,0,0,1,824,689,135,134,36,97,1,0,0,0,1,580,361,219,482012116001,70500.0,29.78467654236162,-95.31157626900836,236,13,17,10,8
86,89,90,1672,588,1672,1315,357,353,58,276,9,6,0,4,4,1160,883,277,274,47,211,7,5,0,4,3,588,497,91,482012116002,61600.0,29.778268279113824,-95.3115346791302,236,12,18,12,8
87,90,91,1511,672,1511,210,1301,1291,8,1281,1,0,1,0,10,1136,127,1009,1001,6,994,0,0,1,0,8,672,593,79,482012117001,71200.0,29.804723298134448,-95.30962052343334,207,12,12,2,6
88,91,92,1033,370,1033,531,502,490,16,472,0,0,1,1,12,748,351,397,391,13,376,0,0,1,1,6,370,324,46,482012117002,81400.0,29.799214368871027,-95.29857478255477,148,13,10,3,8
89,92,93,1342,611,1342,464,878,871,18,834,9,5,0,5,7,968,301,667,662,16,636,5,3,0,2,5,611,491,120,482012117003,71700.0,29.794729215857306,-95.313592958497,229,13,16,6,9
90,93,94,1517,455,1517,1464,53,53,35,14,2,1,0,1,0,1036,994,42,42,30,9,1,1,0,1,0,455,409,46,482012119001,62600.0,29.7835661672872,-95.30503051274596,203,13,15,8,8
91,94,95,1401,412,1401,1367,34,33,29,4,0,0,0,0,1,932,905,27,26,23,3,0,0,0,0,1,412,374,38,482012119002,58300.0,29.78552390153149,-95.29984676569656,177,13,13,4,8
92,95,96,1300,405,1300,1253,47,46,37,4,3,2,0,0,1,848,804,44,43,37,2,3,1,0,0,1,405,360,45,482012119003,61100.0,29.78386979056976,-95.29410561643869,138,13,12,5,8
93,96,97,1007,295,1007,973,34,34,23,1,1,6,0,3,0,710,685,25,25,20,1,1,2,0,1,0,295,274,21,482012119004,62600.0,29.781920937229764,-95.29950376546446,177,13,13,5,8
94,97,98,1107,390,1107,988,119,119,74,40,1,3,0,1,0,798,693,105,105,69,31,1,3,0,1,0,390,339,51,482012123001,75600.0,29.77547935206191,-95.35772349395744,514,13,24,21,20
95,98,99,972,339,972,894,78,76,57,13,1,4,0,1,2,690,624,66,64,46,13,1,4,0,0,2,339,296,43,482012123002,98500.0,29.78056466984849,-95.35724020162016,500,12,22,18,20
96,99,100,676,335,676,493,183,180,32,146,0,1,0,1,3,467,311,156,153,32,119,0,1,0,1,3,335,234,101,482012123003,25000.0,29.77302242049214,-95.35178367281836,503,14,22,22,19
97,100,101,1401,534,1401,1326,75,71,35,28,6,2,0,0,4,987,922,65,64,30,26,6,2,0,0,1,534,436,98,482012123004,74100.0,29.778932188611677,-95.3530123423168,496,11,21,19,19
98,101,102,1225,468,1225,1107,118,114,90,18,1,5,0,0,4,909,803,106,104,81,18,1,4,0,0,2,468,394,74,482012123005,87000.0,29.77801330780209,-95.36373475138356,518,11,24,20,22
99,102,103,1479,474,1479,1402,77,74,43,25,0,5,0,1,3,1022,953,69,67,41,20,0,5,0,1,2,474,428,46,482012124001,67500.0,29.77782439811465,-95.29823233350734,168,12,14,5,8
100,103,104,897,291,897,704,193,193,25,156,12,0,0,0,0,639,474,165,165,22,132,11,0,0,0,0,291,266,25,482012124002,63900.0,29.788592933843898,-95.28289807153784,99,10,10,4,5
101,104,105,840,277,840,813,27,25,14,5,0,2,0,4,2,593,568,25,23,14,5,0,2,0,2,2,277,244,33,482012124003,72500.0,29.77716878519429,-95.30522429778824,204,11,16,9,8
102,105,106,1187,429,1187,675,512,506,11,488,4,2,0,1,6,866,450,416,410,11,392,4,2,0,1,6,429,378,51,482012125001,59700.0,29.768206945529304,-95.2767766093997,85,9,10,4,2
103,106,107,1432,656,1432,196,1236,1222,14,1200,0,5,1,2,14,1137,122,1015,1004,8,994,0,0,0,2,11,656,588,68,482012125002,72500.0,29.764842505392902,-95.27019354385963,66,7,7,3,3
104,107,108,991,481,991,144,847,835,15,816,0,1,0,3,12,807,83,724,717,13,701,0,1,0,2,7,481,428,53,482012125003,72800.0,29.747611844711496,-95.2814689087584,113,9,10,6,6
105,108,109,1394,488,1394,689,705,694,25,660,6,1,0,2,11,952,431,521,514,17,491,4,1,0,1,7,488,423,65,482012201001,60700.0,29.814634121169554,-95.34528342034716,347,11,8,4,12
106,109,110,703,237,703,349,354,353,14,336,3,0,0,0,1,495,216,279,278,5,270,3,0,0,0,1,237,210,27,482012201002,70300.0,29.81657225103859,-95.33886422054248,318,11,8,4,10
107,110,111,1951,630,1951,1794,157,155,129,22,4,0,0,0,2,1374,1233,141,139,119,18,2,0,0,0,2,630,577,53,482012202001,101700.0,29.816662512712902,-95.3690173962074,366,11,10,6,15
108,111,112,1079,386,1079,1005,74,74,58,14,1,1,0,0,0,778,711,67,67,55,10,1,1,0,0,0,386,329,57,482012202002,97300.0,29.8164102157674,-95.35713529609868,362,11,10,6,13
109,112,113,1136,381,1136,1014,122,120,80,21,1,13,0,5,2,800,691,109,109,76,18,1,10,0,4,0,381,349,32,482012203001,90600.0,29.82614760530528,-95.3720182463628,305,10,9,5,13
110,113,114,976,287,976,898,78,77,69,7,0,1,0,0,1,660,594,66,65,59,5,0,1,0,0,1,287,262,25,482012203002,83300.0,29.821755610817128,-95.37074099598132,333,10,10,5,13
111,114,115,2397,753,2397,2165,232,230,199,27,1,1,0,2,2,1672,1468,204,203,178,22,1,1,0,1,1,753,687,66,482012203003,91600.0,29.82452981447187,-95.361283764187,317,9,10,5,13
112,115,116,1448,430,1448,1240,208,205,52,147,1,5,0,0,3,879,753,126,125,44,77,1,3,0,0,1,430,392,38,482012204001,56900.0,29.83534902982176,-95.37192449609142,249,10,7,5,8
113,116,117,2468,753,2468,2268,200,197,164,30,0,2,0,1,3,1692,1516,176,173,148,22,0,2,0,1,3,753,668,85,482012204002,69900.0,29.833155587010445,-95.36198858452217,258,9,7,5,9
114,117,118,1105,306,1105,999,106,101,82,14,3,2,0,0,5,754,662,92,89,74,12,1,2,0,0,3,306,293,13,482012204003,70100.0,29.83082907521857,-95.37197681991472,276,10,9,5,10
115,118,119,920,326,920,824,96,92,65,26,0,1,0,0,4,677,590,87,85,59,25,0,1,0,0,2,326,299,27,482012205001,110700.0,29.828513504465803,-95.3789101212108,306,10,8,5,12
116,119,120,1964,752,1964,1471,493,480,355,122,2,1,0,0,13,1439,995,444,433,328,102,2,1,0,0,11,752,712,40,482012205002,82300.0,29.8414808068903,-95.38007903261678,243,10,7,5,8
117,120,121,1404,865,1404,854,550,544,165,360,1,17,0,1,6,1194,653,541,535,156,360,1,17,0,1,6,865,809,56,482012205003,139000.0,29.839650128457603,-95.3850137462642,262,10,7,5,9
118,121,122,2850,861,2850,1996,854,851,157,682,6,4,0,2,3,1769,1301,468,466,120,336,4,4,0,2,2,861,786,75,482012206001,97600.0,29.84177776705318,-95.36302776692524,232,9,7,5,8
119,122,123,1044,288,1044,941,103,101,87,12,0,1,1,0,2,700,611,89,89,77,10,0,1,1,0,0,288,265,23,482012206002,76300.0,29.84185540634664,-95.37222878960262,235,10,7,5,8
120,123,124,1176,451,1176,754,422,418,80,330,1,2,0,5,4,798,470,328,324,69,252,0,1,0,2,4,451,410,41,482012207001,82800.0,29.842800061108843,-95.3456723094205,183,9,5,3,6
121,124,125,953,315,953,767,186,185,19,166,0,0,0,0,1,674,508,166,165,16,149,0,0,0,0,1,315,276,39,482012207002,64700.0,29.833224013939805,-95.34586573766784,233,9,5,3,7
122,125,126,746,257,746,543,203,203,3,200,0,0,0,0,0,532,362,170,170,3,167,0,0,0,0,0,257,221,36,482012207003,58200.0,29.825527656183077,-95.34635410613264,288,9,8,4,11
123,126,127,1403,452,1403,1105,298,285,19,238,5,21,0,2,13,934,700,234,227,18,195,5,9,0,0,7,452,401,51,482012207004,71900.0,29.82518547563091,-95.35098231036032,302,9,9,5,12
124,127,128,2039,611,2039,1313,726,724,80,637,4,2,0,1,2,1260,838,422,421,65,350,4,2,0,0,1,611,558,53,482012207005,98300.0,29.840213245981158,-95.3529434437085,231,9,6,5,7
125,128,129,1152,381,1152,926,226,223,15,206,0,0,0,2,3,735,547,188,187,14,171,0,0,0,2,1,381,326,55,482012208001,59400.0,29.836536131162816,-95.33821038212469,195,9,5,3,4
126,129,130,2137,854,2137,649,1488,1479,54,1406,6,12,0,1,9,1383,376,1007,1002,49,940,3,9,0,1,5,854,758,96,482012208002,64100.0,29.82625032463577,-95.33885212711108,256,9,7,3,9
127,130,131,857,235,857,641,216,210,29,171,1,6,0,3,6,532,402,130,128,28,92,1,4,0,3,2,235,200,35,482012209001,63200.0,29.85225316979089,-95.33708291195929,135,5,5,3,4
128,131,132,995,315,995,858,137,136,20,105,2,9,0,0,1,681,575,106,105,18,77,1,9,0,0,1,315,280,35,482012209002,90200.0,29.84357845622001,-95.33800498462192,157,9,5,3,4
129,132,133,1768,539,1768,1158,610,598,208,378,0,6,0,6,12,1213,740,473,464,178,278,0,4,0,4,9,539,421,118,482012210001,86500.0,29.86537782265256,-95.34567949348204,127,6,4,3,6
130,133,134,2269,648,2269,1990,279,275,118,150,1,1,0,5,4,1466,1253,213,211,106,101,1,1,0,2,2,648,553,95,482012210002,63200.0,29.855277263091857,-95.34390282253882,130,5,4,3,5
131,134,135,1462,443,1462,1306,156,156,131,12,3,10,0,0,0,976,841,135,135,115,7,3,10,0,0,0,443,398,45,482012211001,101300.0,29.86522789288912,-95.35697241502342,149,6,6,5,7
132,135,136,1195,333,1195,1065,130,129,117,11,0,1,0,0,1,774,674,100,99,93,5,0,1,0,0,1,333,300,33,482012211002,70600.0,29.856442275569417,-95.35576939749372,154,6,6,5,7
133,136,137,941,270,941,832,109,109,66,19,2,18,0,4,0,627,529,98,98,62,19,2,14,0,1,0,270,242,28,482012211003,95000.0,29.850434626241807,-95.35494674896012,176,5,7,5,7
134,137,138,1923,568,1923,1617,306,302,263,35,4,0,0,0,4,1310,1037,273,270,238,28,4,0,0,0,3,568,519,49,482012212001,87500.0,29.86603739847548,-95.367819783425,161,6,6,5,8
135,138,139,1069,303,1069,968,101,99,83,14,1,0,0,1,2,714,625,89,87,76,10,1,0,0,0,2,303,282,21,482012212002,90300.0,29.860700190563477,-95.36760706652214,167,6,6,5,8
136,139,140,3002,828,3002,2599,403,395,344,42,1,5,2,1,8,2023,1685,338,333,294,31,1,5,1,1,5,828,778,50,482012212003,84900.0,29.864755146280643,-95.37839275758748,164,6,6,5,8
137,140,141,1826,537,1826,1683,143,141,92,28,0,13,3,5,2,1218,1104,114,113,76,20,0,13,3,1,1,537,498,39,482012213001,82200.0,29.848957362497647,-95.36586123355669,184,5,7,5,8
138,141,142,879,245,879,764,115,113,92,18,3,0,0,0,2,570,473,97,95,79,15,1,0,0,0,2,245,226,19,482012213002,92300.0,29.85731161556284,-95.36660815518528,164,6,6,5,8
139,142,143,1181,343,1181,1083,98,96,81,11,1,2,0,1,2,786,695,91,91,78,10,0,2,0,1,0,343,320,23,482012213003,85100.0,29.854024593481064,-95.36657903891478,178,5,7,5,8
140,143,144,2252,646,2252,2035,217,215,193,18,1,1,0,2,2,1518,1325,193,191,176,13,1,1,0,0,2,646,597,49,482012213004,89600.0,29.849592285437115,-95.37834795959674,191,6,7,5,8
141,144,145,2455,672,2455,2153,302,286,242,34,2,8,0,0,16,1639,1383,256,247,212,26,2,7,0,0,9,672,613,59,482012213005,92500.0,29.85643345505853,-95.37814556709009,170,6,6,5,8
142,145,146,1090,308,1090,971,119,112,58,53,0,1,0,0,7,705,616,89,88,48,39,0,1,0,0,1,308,286,22,482012214001,88900.0,29.850138633054737,-95.3935358218631,212,6,7,5,9
143,146,147,2201,661,2201,1959,242,237,209,18,1,8,0,1,5,1466,1249,217,216,192,15,1,8,0,0,1,661,608,53,482012214002,81300.0,29.852593074969,-95.3877834769759,205,6,7,5,9
144,147,148,2846,1019,2846,2540,306,299,201,90,3,0,0,5,7,1883,1625,258,253,184,63,3,0,0,3,5,1019,840,179,482012214003,97600.0,29.85669956769276,-95.39594998082828,190,5,6,5,9
145,148,149,2957,833,2957,2642,315,307,225,64,1,13,0,4,8,1932,1664,268,260,202,43,1,13,0,1,8,833,787,46,482012215001,85300.0,29.864898538695112,-95.39000733690902,175,5,6,5,9
146,149,150,2975,1047,2975,1822,1153,1134,94,1025,0,12,1,2,19,1925,1188,737,726,73,640,0,11,1,1,11,1047,939,108,482012215002,105800.0,29.86722347174788,-95.4021800208334,186,5,6,4,9
147,150,151,2327,694,2327,1876,451,450,264,168,2,8,0,8,1,1646,1237,409,408,238,154,2,8,0,6,1,694,651,43,482012215003,104100.0,29.863216692952093,-95.39875305234838,183,5,6,5,9
148,151,152,619,163,619,509,110,109,90,17,0,2,0,0,1,408,306,102,101,84,15,0,2,0,0,1,163,153,10,482012216001,101100.0,29.893743951908498,-95.4105773154904,80,4,5,1,3
149,152,153,1527,410,1527,1270,257,248,202,17,1,25,0,3,9,1018,800,218,214,181,10,1,20,0,2,4,410,395,15,482012216003,116400.0,29.872865380418627,-95.39780681911655,181,5,5,5,9
150,153,154,45,16,45,25,20,17,7,9,0,1,0,0,3,31,15,16,15,7,7,0,1,0,0,1,16,16,0,482012216004,100900.0,29.88269560901937,-95.41022296049778,123,5,5,2,6
151,154,155,1423,384,1423,1242,181,176,143,13,5,9,0,6,5,963,803,160,158,129,11,5,8,0,5,2,384,353,31,482012217001,90400.0,29.88082434661311,-95.37188528761372,109,6,5,4,6
152,155,156,2203,649,2203,1987,216,215,180,24,1,7,1,2,1,1461,1272,189,188,159,18,1,7,1,2,1,649,585,64,482012217002,96000.0,29.87424212559064,-95.37608931540122,159,6,5,5,8
153,156,157,719,191,719,588,131,130,109,16,0,5,0,0,1,490,376,114,114,97,13,0,4,0,0,0,191,183,8,482012217003,85000.0,29.885230055416415,-95.3709285973994,100,6,5,2,6
154,158,159,16,8,16,15,1,1,1,0,0,0,0,0,0,15,14,1,1,1,0,0,0,0,0,0,8,6,2,482012218002,79100.0,29.87338429632393,-95.36057334126588,155,6,5,5,8
155,159,160,0,0,0,0,0,0,0,0,0,0,0,0,0,0,0,0,0,0,0,0,0,0,0,0,0,0,0,482012219001,66200.0,29.890712157593303,-95.35068225835168,81,5,4,1,4
156,160,161,0,0,0,0,0,0,0,0,0,0,0,0,0,0,0,0,0,0,0,0,0,0,0,0,0,0,0,482012219002,84700.0,29.88069103094756,-95.3550937654794,105,6,5,4,5
157,161,162,0,0,0,0,0,0,0,0,0,0,0,0,0,0,0,0,0,0,0,0,0,0,0,0,0,0,0,482012219003,72700.0,29.8748514947694,-95.35377861189262,145,6,4,5,6
158,162,163,2435,586,2435,2089,346,334,213,113,7,1,0,0,12,1693,1386,307,298,193,99,5,1,0,0,9,586,557,29,482012220001,75100.0,29.868087930296717,-95.33703964168576,115,6,3,3,4
159,163,164,0,0,0,0,0,0,0,0,0,0,0,0,0,0,0,0,0,0,0,0,0,0,0,0,0,0,0,482012221002,71300.0,29.87086920138461,-95.33096366413652,118,6,3,3,5
160,164,165,119,33,119,106,13,13,13,0,0,0,0,0,0,72,66,6,6,6,0,0,0,0,0,0,33,33,0,482012223001,87900.0,29.893546852233825,-95.34332038608116,72,5,3,1,3
161,165,166,0,0,0,0,0,0,0,0,0,0,0,0,0,0,0,0,0,0,0,0,0,0,0,0,0,0,0,482012223002,73300.0,29.8983559638411,-95.3550830258601,74,5,5,1,3
162,166,167,0,0,0,0,0,0,0,0,0,0,0,0,0,0,0,0,0,0,0,0,0,0,0,0,0,0,0,482012223003,80900.0,29.88815946589575,-95.33896245026676,77,5,3,1,3
163,167,168,391,126,391,308,83,83,54,5,0,22,0,2,0,265,199,66,66,48,4,0,14,0,0,0,126,100,26,482012224012,95100.0,29.90669626729176,-95.41050481177332,64,4,4,1,1
164,169,170,1011,381,1011,873,138,137,29,94,0,13,0,1,1,658,559,99,98,27,63,0,7,0,1,1,381,279,102,482012225011,91000.0,29.9265467429411,-95.40613614056792,85,3,3,0,2
165,170,171,1849,493,1849,1637,212,208,139,62,0,4,3,0,4,1286,1097,189,186,130,49,0,4,3,0,3,493,477,16,482012225012,42300.0,29.928775163373626,-95.4057723434387,84,3,3,0,2
166,171,172,5,1,5,1,4,4,4,0,0,0,0,0,0,2,1,1,1,1,0,0,0,0,0,0,1,1,0,482012225021,83100.0,29.93061540534044,-95.3880795777417,79,3,3,0,2
167,172,173,2486,636,2486,2045,441,431,291,133,0,7,0,0,10,1661,1303,358,350,252,91,0,7,0,0,8,636,618,18,482012225022,111100.0,29.92448278831513,-95.39607177342928,82,3,3,0,2
168,173,174,2239,550,2239,1984,255,255,173,64,4,14,0,0,0,1512,1289,223,223,162,45,3,13,0,0,0,550,531,19,482012225031,100500.0,29.91909962194273,-95.40433327853614,83,4,4,1,2
169,174,175,2062,678,2062,1974,88,84,38,40,0,2,1,3,4,1352,1281,71,67,31,32,0,2,1,1,4,678,570,108,482012225032,,29.92301625462474,-95.40833244455702,82,4,3,0,2
170,175,176,2313,742,2313,1860,453,440,110,320,0,9,0,1,13,1507,1167,340,331,98,223,0,9,0,1,9,742,617,125,482012225033,88100.0,29.923535135656785,-95.40077124625498,83,4,3,0,2
171,176,177,2716,1349,2716,1897,819,808,75,710,4,15,1,3,11,1906,1238,668,662,72,573,1,14,1,1,6,1349,1062,287,482012226001,,29.936485000109336,-95.40600606620468,79,3,3,0,2
172,177,178,2231,778,2231,2156,75,73,31,29,1,12,0,0,2,1399,1340,59,57,22,26,1,8,0,0,2,778,645,133,482012226002,,29.93508771453968,-95.39024638188891,74,3,3,0,3
173,178,179,1143,532,1143,239,904,902,56,843,0,3,0,0,2,703,126,577,575,49,523,0,3,0,0,2,532,432,100,482012227001,108900.0,29.935877001826437,-95.336631206928,83,2,4,2,3
174,179,180,34,11,34,21,13,12,7,5,0,0,0,0,1,23,10,13,12,7,5,0,0,0,0,1,11,11,0,482012227002,80000.0,29.936037859694792,-95.30048652092988,70,1,3,3,4
175,180,181,0,0,0,0,0,0,0,0,0,0,0,0,0,0,0,0,0,0,0,0,0,0,0,0,0,0,0,482012229001,112900.0,29.92191718485172,-95.35567197044924,79,5,3,2,2
176,181,182,0,0,0,0,0,0,0,0,0,0,0,0,0,0,0,0,0,0,0,0,0,0,0,0,0,0,0,482012229002,97700.0,29.90944631606597,-95.35520418797957,58,5,4,1,2
177,182,183,0,0,0,0,0,0,0,0,0,0,0,0,0,0,0,0,0,0,0,0,0,0,0,0,0,0,0,482012229004,100600.0,29.90436299912554,-95.3550390158904,59,6,4,1,2
178,183,184,0,0,0,0,0,0,0,0,0,0,0,0,0,0,0,0,0,0,0,0,0,0,0,0,0,0,0,482012231001,83100.0,29.926953708590712,-95.32298022590516,64,1,3,2,3
179,184,185,1705,688,1705,311,1394,1384,19,1363,1,0,0,1,10,1155,182,973,963,18,943,1,0,0,1,10,688,597,91,482012301001,58600.0,29.814026569442102,-95.32998805670508,321,10,8,4,8
180,185,186,697,370,697,69,628,621,35,585,1,0,0,0,7,595,48,547,542,35,507,0,0,0,0,5,370,294,76,482012302001,60500.0,29.81251035656202,-95.31537715981432,215,10,10,2,5
181,186,187,614,278,614,103,511,511,5,504,0,2,0,0,0,459,51,408,408,4,402,0,2,0,0,0,278,222,56,482012302002,51400.0,29.822395387065335,-95.31616366761546,179,9,9,1,4
182,187,188,1605,611,1605,151,1454,1438,18,1416,1,1,0,2,16,1081,75,1006,994,10,980,1,1,0,2,12,611,536,75,482012302003,55000.0,29.819882283002546,-95.30764059674652,155,10,8,2,4
183,188,189,1346,562,1346,238,1108,1094,46,1029,1,7,0,11,14,1039,155,884,877,35,827,1,7,0,7,7,562,498,64,482012302004,64300.0,29.829339662315743,-95.30013079220916,94,9,6,1,3
184,189,190,792,303,792,77,715,710,8,701,1,0,0,0,5,600,54,546,541,7,533,1,0,0,0,5,303,288,15,482012302005,75700.0,29.814116261710957,-95.29659219123518,119,11,7,2,5
185,190,191,1185,565,1185,320,865,858,22,834,1,0,0,1,7,889,181,708,701,19,681,0,0,0,1,7,565,440,125,482012303001,62700.0,29.83757522203775,-95.31122975910137,85,8,5,1,1
186,191,192,618,311,618,98,520,511,6,505,0,0,0,0,9,437,46,391,385,5,380,0,0,0,0,6,311,238,73,482012303002,31600.0,29.830428448689705,-95.31500083272724,130,8,8,1,2
187,192,193,843,344,843,289,554,551,8,542,0,0,1,0,3,631,181,450,447,8,438,0,0,1,0,3,344,286,58,482012304001,54100.0,29.833315790622876,-95.32129208013237,137,8,6,2,2
188,193,194,1482,603,1482,616,866,855,18,833,2,2,0,0,11,1037,361,676,669,14,651,2,2,0,0,7,603,511,92,482012304002,54000.0,29.83348475187525,-95.32543837878386,157,8,5,3,3
189,194,195,1394,577,1394,867,527,523,26,494,2,0,0,1,4,991,557,434,430,23,404,2,0,0,1,4,577,454,123,482012304003,45500.0,29.82390161183408,-95.3291000896001,260,8,8,3,7
190,195,196,1261,350,1261,1110,151,149,58,84,0,3,0,4,2,843,724,119,118,50,65,0,3,0,0,1,350,322,28,482012305001,81800.0,29.859244209516618,-95.32510440443264,81,5,4,3,2
191,196,197,1359,387,1359,1176,183,173,64,102,0,6,0,1,10,913,768,145,140,53,81,0,6,0,0,5,387,353,34,482012305002,70500.0,29.8525319058408,-95.32880388170852,128,4,5,3,3
192,197,198,1554,508,1554,1026,528,521,23,492,3,1,1,1,7,1115,674,441,436,22,410,2,1,1,0,5,508,456,52,482012305003,79400.0,29.838804597103916,-95.33083583999569,189,9,5,3,4
193,198,199,1126,425,1126,404,722,720,14,704,1,1,0,0,2,800,248,552,552,13,537,1,1,0,0,0,425,373,52,482012306001,37600.0,29.84493166874299,-95.30284556404084,51,7,5,1,1
194,199,200,1446,597,1446,477,969,954,23,920,4,6,0,1,15,1099,308,791,783,20,752,4,6,0,1,8,597,487,110,482012306002,45900.0,29.84481684456702,-95.31646961143998,90,7,6,1,1
195,200,201,828,273,828,435,393,384,25,357,1,0,1,0,9,571,259,312,304,25,277,1,0,1,0,8,273,248,25,482012307001,55000.0,29.85512288669641,-95.31587447512624,64,4,3,1,1
196,201,202,1464,577,1464,180,1284,1273,7,1262,0,0,0,4,11,1000,107,893,886,5,880,0,0,0,1,7,577,501,76,482012307002,78300.0,29.851360842926194,-95.30908448238928,63,4,3,1,1
197,202,203,359,295,359,15,344,344,2,341,1,0,0,0,0,268,9,259,259,2,256,1,0,0,0,0,295,164,131,482012307003,,29.85076811115932,-95.29620863549864,24,5,3,1,1
198,203,204,1371,494,1371,319,1052,1050,14,1036,0,0,0,0,2,1006,191,815,813,14,799,0,0,0,0,2,494,435,59,482012308001,45900.0,29.843118981049685,-95.2931855700895,23,8,5,1,1
199,204,205,1434,518,1434,318,1116,1111,30,1072,1,1,0,7,5,1099,194,905,903,24,871,1,1,0,6,2,518,475,43,482012308002,70300.0,29.83559642928381,-95.29443306573586,32,9,5,1,1
200,205,206,1084,454,1084,243,841,833,40,790,3,0,0,0,8,829,151,678,674,40,632,2,0,0,0,4,454,391,63,482012309001,39400.0,29.82669891966458,-95.27721242290008,26,8,3,2,1
201,206,207,888,423,888,107,781,778,13,763,2,0,0,0,3,696,72,624,622,13,607,2,0,0,0,2,423,345,78,482012309002,51600.0,29.816451509473342,-95.28089994607296,63,8,5,3,2
202,207,208,1020,378,1020,291,729,715,9,704,1,0,0,1,14,738,171,567,561,5,554,1,0,0,1,6,378,340,38,482012309003,94400.0,29.811799203266425,-95.27581822675968,30,8,4,2,1
203,208,209,1239,462,1239,123,1116,1106,10,1096,0,0,0,0,10,740,67,673,669,8,661,0,0,0,0,4,462,420,42,482012309004,79800.0,29.818015108394665,-95.28811874583884,77,10,7,2,4
204,209,210,2262,784,2262,734,1528,1506,60,1431,9,5,0,1,22,1642,462,1180,1165,59,1096,5,4,0,1,15,784,700,84,482012310001,60700.0,29.840754046020205,-95.27214920858248,13,7,3,2,1
205,210,211,2020,715,2020,742,1278,1267,70,1190,2,3,0,2,11,1461,451,1010,1003,58,938,2,3,0,2,7,715,635,80,482012310002,63500.0,29.839487373964666,-95.28388737758505,16,8,5,2,1
206,211,212,1682,548,1682,901,781,777,130,634,5,3,2,3,4,1171,576,595,593,109,472,4,3,2,3,2,548,490,58,482012311001,68800.0,29.827282505039523,-95.25199097725456,10,6,3,2,1
207,212,213,1466,443,1466,887,579,575,65,502,4,0,0,4,4,978,544,434,432,62,362,4,0,0,4,2,443,398,45,482012311002,59500.0,29.84162475782784,-95.25562699748122,10,7,4,2,1
208,213,214,1581,454,1581,971,610,601,100,496,1,3,0,1,9,1060,615,445,442,90,347,1,3,0,1,3,454,402,52,482012311003,60100.0,29.84243835932651,-95.2578614750393,10,7,4,2,1
209,214,215,3466,1030,3466,1242,2224,2213,81,2120,7,5,0,0,11,2120,728,1392,1389,63,1317,7,2,0,0,3,1030,955,75,482012312001,82200.0,29.861113588220327,-95.24937433254732,12,3,2,1,2
210,215,216,1618,612,1618,225,1393,1380,41,1330,3,3,0,3,13,1176,139,1037,1030,40,983,2,3,0,2,7,612,552,60,482012312002,81600.0,29.84662071544509,-95.24147062930528,5,5,2,1,1
211,216,217,1609,585,1609,321,1288,1283,24,1257,2,0,0,0,5,1002,189,813,813,18,794,1,0,0,0,0,585,528,57,482012312003,72900.0,29.8540677894007,-95.25807004510672,6,4,2,1,1
212,217,218,1793,649,1793,549,1244,1240,70,1159,5,0,1,5,4,1202,309,893,891,65,819,2,0,1,4,2,649,546,103,482012313001,66600.0,29.86061759393038,-95.2726857320868,14,4,1,1,2
213,218,219,2461,979,2461,288,2173,2152,27,2123,0,1,0,1,21,1838,192,1646,1634,26,1606,0,1,0,1,12,979,864,115,482012313002,81700.0,29.85118001670281,-95.26972879964596,8,4,1,1,1
214,219,220,2379,958,2379,108,2271,2255,18,2231,2,2,0,2,16,1921,60,1861,1849,15,1829,1,2,0,2,12,958,905,53,482012314001,74900.0,29.86484003913908,-95.28579643755332,22,4,2,1,3
215,220,221,1553,595,1553,90,1463,1458,13,1439,0,4,0,2,5,1222,58,1164,1160,8,1149,0,2,0,1,4,595,549,46,482012315001,61700.0,29.862770884470223,-95.29697333675,27,5,2,1,1
216,221,222,1153,480,1153,112,1041,1036,7,1027,1,0,0,1,5,841,66,775,771,6,763,1,0,0,1,4,480,400,80,482012315002,71800.0,29.855750789792925,-95.2959664900465,22,6,2,1,1
217,222,223,1230,458,1230,290,940,938,17,916,2,3,0,0,2,912,177,735,733,16,714,0,3,0,0,2,458,415,43,482012316001,60200.0,29.863759471787795,-95.3105002897922,53,5,2,1,1
218,223,224,1592,629,1592,182,1410,1394,26,1360,7,0,0,1,16,1267,112,1155,1147,23,1116,7,0,0,1,8,629,583,46,482012316002,71300.0,29.86049381696326,-95.30561174608668,49,5,2,1,1
219,224,225,113,33,113,71,42,42,17,25,0,0,0,0,0,71,39,32,32,16,16,0,0,0,0,0,33,32,1,482012317002,50400.0,29.86459032861033,-95.32601356719724,79,5,4,3,3
220,225,226,996,353,996,310,686,683,6,674,1,2,0,0,3,750,186,564,562,6,553,1,2,0,0,2,353,337,16,482012318001,90200.0,29.86988020587258,-95.30785532420346,53,5,2,1,2
221,226,227,1768,536,1768,1268,500,495,91,395,5,4,0,0,5,1213,803,410,405,80,319,3,3,0,0,5,536,498,38,482012318002,56700.0,29.88083376090527,-95.30573972639203,48,5,2,1,2
222,227,228,1749,653,1749,275,1474,1465,56,1384,14,10,0,1,9,1371,174,1197,1190,44,1127,8,10,0,1,7,653,615,38,482012319001,65300.0,29.885636582015135,-95.2917959370259,23,4,2,1,2
223,228,229,1334,484,1334,150,1184,1180,9,1166,1,0,0,4,4,1024,88,936,933,9,922,0,0,0,2,3,484,455,29,482012319002,49600.0,29.87635503781383,-95.28256837499632,25,4,2,1,3
224,229,230,1083,418,1083,165,918,917,13,902,0,2,0,0,1,840,105,735,735,11,722,0,2,0,0,0,418,393,25,482012319003,83000.0,29.87555235214722,-95.29318191239592,26,4,2,1,2
225,230,231,1061,351,1061,316,745,740,30,708,0,1,0,1,5,749,186,563,560,26,532,0,1,0,1,3,351,329,22,482012319004,65800.0,29.88165160948436,-95.29815635274312,36,5,2,1,2
226,231,232,1638,604,1638,175,1463,1458,9,1445,0,2,0,2,5,1311,102,1209,1206,9,1195,0,2,0,0,3,604,577,27,482012320001,77500.0,29.905111362270176,-95.29227895462228,23,3,2,0,2
227,233,234,1110,349,1110,557,553,538,504,20,8,4,0,2,15,756,328,428,424,400,13,6,4,0,1,4,349,335,14,482012322001,82200.0,29.937471324472117,-95.27942749999406,75,1,3,3,5
228,234,235,71,25,71,34,37,37,30,0,0,7,0,0,0,49,21,28,28,25,0,0,3,0,0,0,25,24,1,482012322003,270800.0,29.935908227445115,-95.28651570307623,73,1,3,3,4
229,235,236,531,211,531,363,168,163,104,51,0,8,0,0,5,349,217,132,128,87,33,0,8,0,0,4,211,156,55,482012322004,67200.0,29.93580329147925,-95.29317590758455,70,1,3,3,4
230,236,237,0,0,0,0,0,0,0,0,0,0,0,0,0,0,0,0,0,0,0,0,0,0,0,0,0,0,0,482012323013,89900.0,29.844562430782304,-95.22790695233806,6,2,3,1,0
231,238,239,1283,359,1283,955,328,326,38,278,0,10,0,0,2,831,601,230,229,32,191,0,6,0,0,1,359,344,15,482012324012,97400.0,29.817740528903396,-95.21753861159549,8,2,2,1,0
232,239,240,0,0,0,0,0,0,0,0,0,0,0,0,0,0,0,0,0,0,0,0,0,0,0,0,0,0,0,482012324021,96100.0,29.80707606905496,-95.18364045255056,9,2,2,1,1
233,240,241,600,334,600,457,143,136,25,110,0,1,0,0,7,364,272,92,90,22,67,0,1,0,0,2,334,180,154,482012324031,85600.0,29.81472796794499,-95.20571398555025,9,2,2,1,1
234,241,242,3135,865,3135,2109,1026,1014,407,582,9,11,0,5,12,2300,1464,836,830,373,440,6,8,0,3,6,865,797,68,482012325001,69100.0,29.80558392437508,-95.24581961867383,11,7,4,2,1
235,242,243,1330,418,1330,1057,273,264,227,31,1,3,0,2,9,942,703,239,232,202,25,1,3,0,1,7,418,401,17,482012326001,92800.0,29.78366087775373,-95.25482155697598,30,9,6,2,2
236,243,244,1670,495,1670,1251,419,411,205,194,2,0,0,10,8,1195,850,345,337,178,153,2,0,0,4,8,495,483,12,482012326002,95300.0,29.782418135861825,-95.24075502275484,25,6,5,2,2
237,244,245,2727,1003,2727,1493,1234,1205,152,1031,2,19,0,1,29,1892,963,929,908,136,753,1,17,0,1,21,1003,796,207,482012327011,93700.0,29.79105785351696,-95.22854211833172,12,3,5,2,1
238,245,246,480,173,480,201,279,277,23,244,0,10,0,0,2,327,135,192,192,18,164,0,10,0,0,0,173,151,22,482012327012,,29.780383955448904,-95.22507638649948,14,3,5,1,1
239,246,247,4028,1413,4028,3152,876,853,129,696,5,18,0,5,23,2535,1954,581,575,97,452,4,18,0,4,6,1413,1199,214,482012327013,26900.0,29.777254802816337,-95.2250271041668,15,2,6,1,1
240,247,248,2535,1146,2535,2250,285,277,68,175,13,21,0,0,8,1747,1544,203,199,54,120,6,19,0,0,4,1146,750,396,482012327021,71500.0,29.77277420459105,-95.22003555958098,21,2,5,1,1
241,248,249,225,89,225,134,91,91,3,85,2,1,0,0,0,169,90,79,79,3,73,2,1,0,0,0,89,72,17,482012327022,94200.0,29.774462834802023,-95.22593752415432,20,2,6,1,1
242,249,250,2457,931,2457,1211,1246,1222,499,689,9,16,0,9,24,1723,772,951,933,448,459,8,11,0,7,18,931,875,56,482012327023,107600.0,29.787130127728517,-95.21149895602916,12,2,3,1,1
243,250,251,9,2,9,0,9,9,0,9,0,0,0,0,0,7,0,7,7,0,7,0,0,0,0,0,2,2,0,482012328001,116200.0,29.785493559015816,-95.20429226152956,9,2,3,1,2
244,252,253,0,0,0,0,0,0,0,0,0,0,0,0,0,0,0,0,0,0,0,0,0,0,0,0,0,0,0,482012329001,102700.0,29.795295893556748,-95.1880902947042,9,2,3,1,2
245,254,255,925,456,925,325,600,589,51,509,0,29,0,0,11,602,196,406,401,37,339,0,25,0,0,5,456,369,87,482012329003,104100.0,29.804532177705685,-95.18260171666184,9,2,3,1,2
246,256,257,1734,1001,1734,825,909,902,149,737,4,7,0,5,7,1108,502,606,602,124,462,4,7,0,5,4,1001,596,405,482012330012,55000.0,29.795429848840545,-95.1855354300033,9,2,3,1,2
247,257,258,0,0,0,0,0,0,0,0,0,0,0,0,0,0,0,0,0,0,0,0,0,0,0,0,0,0,0,482012330031,108500.0,29.79127434077428,-95.17403793271832,10,1,3,1,2
248,258,259,2,1,2,0,2,0,0,0,0,0,0,0,2,2,0,2,0,0,0,0,0,0,0,2,1,1,0,482012330032,110400.0,29.791617771194456,-95.16362918404742,11,1,3,1,2
249,260,261,0,0,0,0,0,0,0,0,0,0,0,0,0,0,0,0,0,0,0,0,0,0,0,0,0,0,0,482012331013,101500.0,29.791136281268148,-95.17414833485438,10,1,3,1,2
250,262,263,0,0,0,0,0,0,0,0,0,0,0,0,0,0,0,0,0,0,0,0,0,0,0,0,0,0,0,482012331022,64200.0,29.79041791079629,-95.16619614770306,10,1,3,1,2
251,263,264,12,6,12,12,0,0,0,0,0,0,0,0,0,9,9,0,0,0,0,0,0,0,0,0,6,5,1,482012331023,39500.0,29.77130232645127,-95.16664576006532,11,1,3,2,2
252,264,265,20,8,20,18,2,2,0,2,0,0,0,0,0,15,14,1,1,0,1,0,0,0,0,0,8,8,0,482012331031,62500.0,29.771101790782676,-95.17332900719155,11,1,3,2,2
253,265,266,219,61,219,171,48,47,38,6,2,0,0,1,1,154,116,38,37,31,4,2,0,0,0,1,61,56,5,482012331032,48800.0,29.774900288984004,-95.18156405986127,8,1,3,1,2
254,266,267,1493,473,1493,931,562,558,481,72,3,2,0,0,4,1021,567,454,452,409,40,1,2,0,0,2,473,450,23,482012332001,85900.0,29.783112437233523,-95.1976921774466,9,2,3,1,2
255,267,268,1675,504,1675,1147,528,522,476,42,2,2,0,0,6,1107,672,435,431,400,27,2,2,0,0,4,504,476,28,482012332002,83800.0,29.777809769066312,-95.19602002555372,8,2,3,1,2
256,268,269,1509,454,1509,1173,336,329,284,35,2,3,2,3,7,1015,730,285,282,244,31,2,3,2,0,3,454,419,35,482012332003,77500.0,29.775833886440637,-95.18755206941402,8,1,3,1,2
257,269,270,1555,449,1555,1193,362,360,310,34,1,13,0,2,2,1020,726,294,292,260,18,1,11,0,2,2,449,419,30,482012332004,78400.0,29.784855979848015,-95.1872157320023,9,2,3,1,2
258,271,272,2151,583,2151,1879,272,269,241,15,10,2,0,1,3,1393,1154,239,238,220,11,5,2,0,0,1,583,551,32,482012333002,73900.0,29.765720370628195,-95.21890067435972,30,1,4,1,1
259,272,273,1620,440,1620,1462,158,157,134,15,0,6,0,2,1,1080,946,134,133,112,15,0,5,0,1,1,440,413,27,482012333003,77300.0,29.76579713074658,-95.20888473450329,11,1,4,1,1
260,274,275,0,0,0,0,0,0,0,0,0,0,0,0,0,0,0,0,0,0,0,0,0,0,0,0,0,0,0,482012334002,68500.0,29.772126538065585,-95.25960862369269,48,7,8,2,2
261,275,276,0,0,0,0,0,0,0,0,0,0,0,0,0,0,0,0,0,0,0,0,0,0,0,0,0,0,0,482012335003,86100.0,29.76033389200917,-95.22114085066758,29,2,5,1,2
262,276,277,1059,463,1059,249,810,804,5,795,1,2,0,1,6,786,140,646,640,5,631,1,2,0,1,6,463,394,69,482012336001,53400.0,29.753094659605445,-95.2593864366942,53,7,8,3,4
263,277,278,1068,477,1068,277,791,788,5,776,4,3,0,0,3,778,153,625,622,5,612,2,3,0,0,3,477,382,95,482012336002,51500.0,29.73928550511566,-95.26082646561407,60,6,8,3,4
264,280,281,1563,811,1563,991,572,560,76,456,4,18,1,5,12,1081,650,431,423,62,334,4,18,1,4,8,811,643,168,482012401001,,29.94282009429696,-95.39155957779192,68,2,3,1,1
265,281,282,1504,769,1504,760,744,725,68,647,3,4,1,2,19,1051,491,560,549,62,477,3,4,1,2,11,769,633,136,482012401002,89300.0,29.946143425189536,-95.40934980702376,71,2,2,2,0
266,282,283,0,0,0,0,0,0,0,0,0,0,0,0,0,0,0,0,0,0,0,0,0,0,0,0,0,0,0,482012404001,141000.0,30.02157548870865,-95.39013816486312,68,2,1,6,2
267,284,285,951,674,951,172,779,769,46,709,1,2,2,9,10,713,116,597,592,40,542,1,2,2,5,5,674,488,186,482012405011,121900.0,29.95446768585795,-95.38672571644904,77,2,2,6,1
268,285,286,1501,713,1501,882,619,600,31,547,2,11,0,9,19,1013,566,447,435,27,389,2,10,0,7,12,713,577,136,482012405012,,29.95205745060661,-95.39442761471014,78,2,2,6,1
269,286,287,1456,770,1456,850,606,582,53,526,0,3,0,0,24,991,524,467,451,48,400,0,3,0,0,16,770,571,199,482012405021,132000.0,29.946998232643185,-95.39210803762234,68,2,2,3,1
270,287,288,1895,997,1895,1027,868,861,79,766,4,7,0,5,7,1330,693,637,631,68,549,3,6,0,5,6,997,781,216,482012405022,,29.949346560399032,-95.39605600773932,79,1,2,3,1
271,288,289,2243,979,2243,1251,992,981,49,922,0,9,0,1,11,1390,758,632,627,30,588,0,9,0,0,5,979,848,131,482012405023,,29.94979775457773,-95.3886816326972,76,2,2,3,1
272,290,291,573,362,573,134,439,430,83,309,4,29,3,2,9,473,110,363,359,77,251,4,24,3,0,4,362,299,63,482012407011,126500.0,30.001079604888385,-95.42204175832032,70,2,1,6,0
273,291,292,0,0,0,0,0,0,0,0,0,0,0,0,0,0,0,0,0,0,0,0,0,0,0,0,0,0,0,482012407012,118200.0,30.019303699369114,-95.4246329602918,62,2,1,6,1
274,292,293,599,171,599,277,322,320,23,283,3,11,0,0,2,352,163,189,189,17,163,2,7,0,0,0,171,167,4,482012407021,54100.0,29.98978082494544,-95.4160847762634,80,3,2,6,0
275,293,294,3,1,3,3,0,0,0,0,0,0,0,0,0,2,2,0,0,0,0,0,0,0,0,0,1,1,0,482012407022,116100.0,29.97201811498445,-95.42019031523144,73,3,2,6,0
276,294,295,4,1,4,4,0,0,0,0,0,0,0,0,0,2,2,0,0,0,0,0,0,0,0,0,1,1,0,482012408011,139800.0,30.024530698686284,-95.419770227897,64,2,1,6,1
277,295,296,1,1,1,1,0,0,0,0,0,0,0,0,0,1,1,0,0,0,0,0,0,0,0,0,1,1,0,482012408012,,30.02456118518174,-95.42575033535786,55,2,1,6,1
278,296,297,0,0,0,0,0,0,0,0,0,0,0,0,0,0,0,0,0,0,0,0,0,0,0,0,0,0,0,482012408014,,30.030229106397325,-95.42815013530796,55,2,2,6,1
279,297,298,0,0,0,0,0,0,0,0,0,0,0,0,0,0,0,0,0,0,0,0,0,0,0,0,0,0,0,482012408021,135000.0,30.020909044741813,-95.37823038882335,68,2,1,6,2
280,298,299,13,5,13,1,12,12,8,4,0,0,0,0,0,9,1,8,8,6,2,0,0,0,0,0,5,5,0,482012408022,113900.0,30.023932528659213,-95.38915602960864,65,2,1,6,2
281,299,300,0,0,0,0,0,0,0,0,0,0,0,0,0,0,0,0,0,0,0,0,0,0,0,0,0,0,0,482012409021,125200.0,30.028814173044367,-95.26174285935144,88,2,3,6,5
282,301,302,0,0,0,0,0,0,0,0,0,0,0,0,0,0,0,0,0,0,0,0,0,0,0,0,0,0,0,482012413001,149100.0,30.047920741335883,-95.42923568823096,53,1,2,6,1
283,302,303,231,76,231,76,155,154,98,38,0,17,0,1,1,154,56,98,97,57,26,0,13,0,1,1,76,72,4,482012413002,166500.0,30.06315759661907,-95.43137700655424,39,1,2,6,1
284,303,304,80,40,80,26,54,54,28,5,0,21,0,0,0,66,21,45,45,27,5,0,13,0,0,0,40,38,2,482012413003,169700.0,30.073769677570628,-95.42649067822089,34,1,2,6,1
285,304,305,1366,662,1366,292,1074,1054,229,784,3,27,9,2,20,976,195,781,769,206,527,3,24,7,2,12,662,604,58,482012415001,83800.0,29.993209644600697,-95.29224826623712,79,2,2,6,4
286,305,306,1886,595,1886,859,1027,1013,333,660,3,16,0,1,14,1254,524,730,724,273,433,3,14,0,1,6,595,569,26,482012415002,77600.0,29.96769569657339,-95.29381022345788,69,2,3,3,3
287,306,307,3597,1052,3597,1303,2294,2251,589,1553,2,75,20,12,43,2562,934,1628,1602,540,976,1,69,9,7,26,1052,945,107,482012415003,72800.0,29.954257267245683,-95.32723854169764,80,2,4,3,3
288,307,308,0,0,0,0,0,0,0,0,0,0,0,0,0,0,0,0,0,0,0,0,0,0,0,0,0,0,0,482012415004,77100.0,29.94129938501047,-95.36573198931748,73,3,3,1,3
289,308,309,148,58,148,60,88,85,78,5,1,1,0,0,3,106,33,73,72,67,3,1,1,0,0,1,58,54,4,482012501002,111200.0,29.94878939313308,-95.28396919577776,77,2,3,3,4
290,311,312,0,0,0,0,0,0,0,0,0,0,0,0,0,0,0,0,0,0,0,0,0,0,0,0,0,0,0,482012504011,156300.0,29.99503507875266,-95.17245772836294,56,1,2,3,6
291,312,313,0,0,0,0,0,0,0,0,0,0,0,0,0,0,0,0,0,0,0,0,0,0,0,0,0,0,0,482012504012,120100.0,29.997659775989245,-95.16438967350145,53,1,2,1,4
292,313,314,6,2,6,1,5,5,5,0,0,0,0,0,0,4,1,3,3,3,0,0,0,0,0,0,2,2,0,482012504021,204000.0,29.9891419612816,-95.137522989986,38,1,4,0,4
293,314,315,3,3,3,0,3,3,2,0,0,1,0,0,0,3,0,3,3,2,0,0,1,0,0,0,3,2,1,482012504022,237500.0,29.99799366282996,-95.1563969604074,41,1,2,1,3
294,316,317,0,0,0,0,0,0,0,0,0,0,0,0,0,0,0,0,0,0,0,0,0,0,0,0,0,0,0,482012505001,129600.0,29.99884172696824,-95.20246024680536,85,2,4,6,6
295,317,318,0,0,0,0,0,0,0,0,0,0,0,0,0,0,0,0,0,0,0,0,0,0,0,0,0,0,0,482012505002,107500.0,29.9968207276088,-95.1728704135432,59,1,2,3,6
296,318,319,147,61,147,11,136,133,106,13,3,10,1,0,3,128,9,119,117,95,9,3,9,1,0,2,61,60,1,482012506005,66600.0,29.98908611937932,-95.23398304299307,72,3,4,6,7
297,320,321,213,98,213,34,179,175,165,9,1,0,0,0,4,174,27,147,145,139,5,1,0,0,0,2,98,87,11,482012507012,122500.0,30.0144396697498,-95.2211474793564,75,2,4,7,4
298,322,323,52,16,52,11,41,39,39,0,0,0,0,0,2,39,8,31,30,30,0,0,0,0,0,1,16,16,0,482012507021,140200.0,30.000933467604632,-95.18876677698512,76,2,4,5,5
299,326,327,242,84,242,37,205,204,194,5,1,4,0,0,1,180,22,158,157,148,5,1,3,0,0,1,84,81,3,482012508003,182000.0,30.02574340914212,-95.15993404892605,36,1,2,2,2
300,327,328,1400,455,1400,80,1320,1301,1242,19,1,30,0,9,19,974,47,927,918,871,14,0,27,0,6,9,455,450,5,482012509001,299300.0,30.05364255778645,-95.1550511475264,38,1,2,2,2
301,328,329,2763,1667,2763,208,2555,2531,2364,97,9,53,1,7,24,2256,142,2114,2100,1963,76,7,46,1,7,14,1667,1318,349,482012509002,278700.0,30.042426466865912,-95.1683592003292,55,1,2,2,3
302,329,330,1151,357,1151,88,1063,1050,995,12,3,40,0,0,13,762,54,708,707,671,9,1,26,0,0,1,357,347,10,482012509003,360500.0,30.06403143257104,-95.15023625961813,37,1,3,2,2
303,330,331,3255,1080,3255,220,3035,3010,2858,53,11,82,1,5,25,2246,123,2123,2112,2009,36,8,55,1,3,11,1080,1044,36,482012509004,399400.0,30.0404594678443,-95.14092924743818,33,1,2,1,2
304,331,332,1993,1125,1993,273,1720,1677,1411,138,5,110,3,10,43,1595,199,1396,1370,1179,97,5,79,3,7,26,1125,1011,114,482012510001,475000.0,30.03441860088476,-95.18675597572924,71,2,4,5,4
305,332,333,781,353,781,54,727,719,685,12,2,20,0,0,8,658,40,618,610,588,9,0,13,0,0,8,353,330,23,482012510002,295300.0,30.0361443259164,-95.20803570436816,79,2,4,7,4
306,333,334,1365,547,1365,136,1229,1218,1156,35,2,20,3,2,11,1075,90,985,977,934,25,2,14,1,1,8,547,529,18,482012511001,157200.0,30.046035608396657,-95.22287566547776,79,2,4,7,4
307,334,335,1216,493,1216,176,1040,1031,938,67,5,14,7,0,9,916,106,810,806,744,44,5,9,4,0,4,493,462,31,482012511002,177700.0,30.036389098163525,-95.22135076449167,79,2,4,7,4
308,335,336,2110,811,2110,263,1847,1820,1674,45,16,83,0,2,27,1669,166,1503,1482,1363,34,15,70,0,0,21,811,784,27,482012511003,164900.0,30.039782477122007,-95.23328604306398,79,2,4,7,5
309,336,337,630,271,630,73,557,549,502,31,1,13,2,0,8,480,46,434,429,398,19,1,10,1,0,5,271,247,24,482012511004,191500.0,30.026196032832235,-95.23205878449282,75,2,4,7,5
310,337,338,2079,845,2079,447,1632,1599,1402,133,15,36,10,3,33,1572,270,1302,1291,1150,93,12,29,5,2,11,845,792,53,482012511005,144600.0,30.036578556584324,-95.24839399735812,78,2,3,7,5
311,338,339,1776,729,1776,249,1527,1503,1377,73,0,48,0,5,24,1301,163,1138,1126,1038,54,0,29,0,5,12,729,639,90,482012512001,116200.0,30.063660354164703,-95.21605470848,82,2,4,7,5
312,339,340,2438,967,2438,361,2077,2042,1919,81,3,38,1,0,35,1787,231,1556,1540,1451,56,3,29,1,0,16,967,883,84,482012512002,141600.0,30.056110565727263,-95.21993091408277,74,2,3,7,4
313,340,341,491,184,491,62,429,423,399,9,0,10,3,2,6,375,37,338,335,315,8,0,8,2,2,3,184,176,8,482012512003,157400.0,30.053958567722034,-95.22969784625651,75,2,3,7,4
314,341,342,1694,633,1694,308,1386,1355,1278,48,5,20,0,4,31,1202,165,1037,1022,968,32,5,14,0,3,15,633,603,30,482012513001,136800.0,30.062402910351068,-95.19255408267152,77,2,4,7,5
315,342,343,1853,618,1853,197,1656,1640,1559,48,1,27,0,5,16,1337,129,1208,1200,1142,34,0,20,0,4,8,618,608,10,482012513002,151800.0,30.064537192864712,-95.20256582323437,82,2,4,7,5
316,343,344,959,342,959,76,883,871,831,11,2,22,0,5,12,710,47,663,657,623,10,2,20,0,2,6,342,333,9,482012513003,173600.0,30.059754785133823,-95.20723117372908,74,2,3,7,5
317,344,345,1609,624,1609,118,1491,1470,1441,20,1,8,0,0,21,1267,78,1189,1180,1153,18,1,8,0,0,9,624,603,21,482012513004,232800.0,30.049501074496703,-95.20274074754012,79,2,4,7,4
318,345,346,1044,448,1044,74,970,946,916,12,7,11,0,0,24,813,54,759,748,725,9,7,7,0,0,11,448,429,19,482012513005,197500.0,30.053823129004115,-95.19178401502016,70,2,3,6,4
319,346,347,2446,834,2446,385,2061,2034,1864,80,10,78,0,2,27,1661,229,1432,1421,1304,53,5,59,0,0,11,834,809,25,482012514011,147700.0,30.080891915648134,-95.1912573919037,57,2,2,4,5
320,347,348,2706,1035,2706,468,2238,2207,2081,75,3,41,0,7,31,1927,295,1632,1615,1516,56,3,36,0,4,17,1035,1006,29,482012514021,116600.0,30.07399953082038,-95.20681357057316,74,2,3,5,5
321,348,349,1741,636,1741,234,1507,1482,1397,43,6,34,2,0,25,1262,152,1110,1098,1028,35,4,29,2,0,12,636,611,25,482012514022,122400.0,30.07243520170204,-95.19314624550152,71,2,3,5,4
322,349,350,1477,687,1477,241,1236,1226,1141,49,4,28,0,4,10,1106,157,949,942,874,37,4,23,0,4,7,687,644,43,482012514023,100400.0,30.072490623062507,-95.20002851148551,75,2,3,5,4
323,350,351,4759,1489,4759,550,4209,4121,3615,128,18,351,4,5,88,2993,315,2678,2643,2306,85,12,233,4,3,35,1489,1423,66,482012515011,228900.0,30.087337799010697,-95.1699407284059,53,1,2,3,5
324,351,352,1590,543,1590,121,1469,1455,1412,10,4,19,9,1,14,1153,75,1078,1069,1037,9,4,14,4,1,9,543,529,14,482012515021,258900.0,30.058396127769548,-95.16327078389038,47,1,2,2,2
325,352,353,1478,548,1478,133,1345,1326,1253,12,5,48,2,6,19,1128,100,1028,1020,964,11,4,36,0,5,8,548,535,13,482012515022,208900.0,30.06213483760944,-95.17733504330693,59,1,3,5,5
326,353,354,1417,458,1417,95,1322,1292,1184,39,8,56,2,3,30,1008,59,949,928,847,27,6,45,2,1,21,458,448,10,482012515023,229000.0,30.065283362939542,-95.16679729524296,59,1,3,2,4
327,354,355,2220,787,2220,207,2013,1987,1833,74,1,71,0,8,26,1609,131,1478,1464,1351,49,1,60,0,3,14,787,759,28,482012515024,204900.0,30.06838683658172,-95.178209532935,59,1,3,5,5
328,355,356,1227,563,1227,85,1142,1130,1090,22,1,15,1,1,12,1005,57,948,944,916,12,1,13,1,1,4,563,540,23,482012515025,161000.0,30.058079839967185,-95.17921167400652,53,1,2,5,4
329,356,357,1487,734,1487,205,1282,1259,1138,64,2,43,1,11,23,1162,148,1014,1003,903,56,2,33,1,8,11,734,630,104,482012515026,247800.0,30.054288523436867,-95.17643376820668,52,1,2,5,4
330,357,358,2264,798,2264,269,1995,1958,1827,39,6,78,3,5,37,1549,161,1388,1375,1271,30,3,67,2,2,13,798,773,25,482012515031,143900.0,30.07361657459541,-95.1850726006418,65,2,3,5,5
331,358,359,39,12,39,5,34,34,34,0,0,0,0,0,0,27,2,25,25,25,0,0,0,0,0,0,12,10,2,482012516001,99800.0,30.06194961454249,-95.10458635920055,23,1,2,1,2
332,359,360,354,174,354,18,336,333,318,5,7,0,0,3,3,300,14,286,284,271,5,5,0,0,3,2,174,150,24,482012516002,213600.0,30.061286210552343,-95.12863884523284,26,1,2,1,2
333,361,362,2895,1040,2895,384,2511,2476,2405,36,11,22,2,0,35,1971,212,1759,1744,1698,23,6,15,2,0,15,1040,974,66,482012517002,99200.0,30.02437675224331,-95.11699665456342,29,1,2,1,2
334,362,363,130,50,130,20,110,110,109,1,0,0,0,0,0,97,12,85,85,84,1,0,0,0,0,0,50,46,4,482012517003,84000.0,30.040963507638214,-95.10928149997828,25,1,2,1,2
335,363,364,1027,440,1027,116,911,898,768,91,10,12,1,16,13,739,84,655,650,558,58,10,11,1,12,5,440,376,64,482012517004,154800.0,30.0042417604388,-95.11764780788288,29,1,2,1,2
336,364,365,122,51,122,6,116,116,109,0,0,7,0,0,0,91,3,88,88,82,0,0,6,0,0,0,51,43,8,482012519012,73100.0,29.98628770629618,-95.122549982679,37,1,4,0,4
337,365,366,0,0,0,0,0,0,0,0,0,0,0,0,0,0,0,0,0,0,0,0,0,0,0,0,0,0,0,482012519013,116200.0,29.93165298499551,-95.12806018820798,21,0,2,0,2
338,366,367,0,0,0,0,0,0,0,0,0,0,0,0,0,0,0,0,0,0,0,0,0,0,0,0,0,0,0,482012519014,119600.0,29.95981956835418,-95.13332109534534,25,0,3,0,2
339,367,368,0,0,0,0,0,0,0,0,0,0,0,0,0,0,0,0,0,0,0,0,0,0,0,0,0,0,0,482012519021,109700.0,29.90279266321392,-95.12155864990316,12,0,2,0,2
340,370,371,5,5,5,0,5,5,5,0,0,0,0,0,0,5,0,5,5,5,0,0,0,0,0,0,5,4,1,482012521001,91300.0,29.90799525348534,-95.13651230986405,14,0,2,0,2
341,371,372,383,200,383,147,236,226,38,170,3,15,0,0,10,273,102,171,163,33,116,3,11,0,0,8,200,178,22,482012522002,123200.0,29.83949903556617,-95.167906419437,9,1,2,1,1
342,372,373,0,0,0,0,0,0,0,0,0,0,0,0,0,0,0,0,0,0,0,0,0,0,0,0,0,0,0,482012524002,98500.0,29.78982397801138,-95.1597014688812,11,1,3,1,1
343,376,377,0,0,0,0,0,0,0,0,0,0,0,0,0,0,0,0,0,0,0,0,0,0,0,0,0,0,0,482012526004,103200.0,29.78850717162806,-95.0936091190651,10,0,1,0,1
344,378,379,0,0,0,0,0,0,0,0,0,0,0,0,0,0,0,0,0,0,0,0,0,0,0,0,0,0,0,482012545002,64400.0,29.73043773619748,-95.02422211815782,30,1,2,5,1
345,379,380,0,0,0,0,0,0,0,0,0,0,0,0,0,0,0,0,0,0,0,0,0,0,0,0,0,0,0,482012546002,64800.0,29.714550073034083,-95.0192498256216,22,0,2,5,1
346,380,381,3029,1272,3029,1144,1885,1839,483,1306,5,43,0,2,46,2146,797,1349,1318,457,813,5,41,0,2,31,1272,1148,124,482013101001,154700.0,29.75895708975117,-95.34289807762818,478,13,21,23,20
347,381,382,2855,1243,2855,1473,1382,1356,793,479,8,76,0,0,26,2363,1124,1239,1214,743,392,8,71,0,0,25,1243,1056,187,482013101002,83900.0,29.75200045205512,-95.34360265226964,470,13,21,23,21
348,382,383,1463,883,1463,331,1132,1099,535,427,0,133,0,4,33,1299,280,1019,994,522,350,0,119,0,3,25,883,738,145,482013102001,218300.0,29.743481009083037,-95.35112432114023,490,14,21,25,20
349,383,384,882,393,882,647,235,230,199,19,5,4,2,1,5,701,494,207,204,177,18,3,3,2,1,3,393,339,54,482013103001,144200.0,29.74064447537674,-95.33051158136024,378,13,21,23,14
350,384,385,743,356,743,565,178,165,110,28,2,20,0,5,13,581,418,163,153,105,23,2,18,0,5,10,356,294,62,482013103002,131300.0,29.73720043517336,-95.33116659341812,383,13,21,22,14
351,385,386,758,451,758,649,109,104,57,32,0,15,0,0,5,563,469,94,89,47,28,0,14,0,0,5,451,253,198,482013103003,110600.0,29.733528771557783,-95.33775823089198,443,14,21,22,18
352,386,387,1071,568,1071,631,440,422,274,72,7,68,0,1,18,891,492,399,387,263,59,4,60,0,1,12,568,478,90,482013103004,142900.0,29.735988686529957,-95.33600488665446,437,14,21,22,17
353,387,388,712,291,712,570,142,135,105,9,2,18,0,1,7,534,416,118,112,90,5,2,15,0,0,6,291,241,50,482013103005,126000.0,29.741473946604877,-95.33605348108522,437,14,21,23,17
354,388,389,608,241,608,504,104,99,40,47,4,7,0,1,5,457,367,90,85,37,38,3,7,0,0,5,241,199,42,482013103006,78000.0,29.7425610356401,-95.33946902079936,455,14,21,23,19
355,389,390,1663,558,1663,1571,92,90,76,5,1,2,0,6,2,1199,1126,73,71,60,5,1,2,0,3,2,558,493,65,482013104001,81100.0,29.754032042750552,-95.32671263951552,340,13,21,23,15
356,390,391,948,364,948,884,64,63,33,25,4,1,0,0,1,694,634,60,59,30,24,4,1,0,0,1,364,290,74,482013104002,71000.0,29.749651250265835,-95.3340981340462,414,13,21,23,17
357,391,392,1473,625,1473,1334,139,132,82,37,1,12,0,0,7,1103,981,122,118,69,37,1,11,0,0,4,625,536,89,482013104003,110300.0,29.7459339183275,-95.33093582402948,385,14,21,23,14
358,392,393,749,296,749,699,50,48,41,7,0,0,0,0,2,508,461,47,45,38,7,0,0,0,0,2,296,244,52,482013105001,79300.0,29.749865266820496,-95.313599154661,237,11,18,16,11
359,393,394,2425,781,2425,2066,359,354,165,171,4,11,0,3,5,1729,1406,323,320,152,153,4,10,0,1,3,781,672,109,482013105002,81700.0,29.74132024461668,-95.31793921289228,276,10,23,20,11
360,394,395,1682,600,1682,1631,51,48,38,5,2,1,2,0,3,1212,1173,39,38,30,5,1,1,1,0,1,600,523,77,482013105003,59700.0,29.74579970555385,-95.32467443491352,310,14,21,22,14
361,395,396,1018,366,1018,912,106,103,64,25,2,12,0,0,3,738,648,90,89,61,17,2,9,0,0,1,366,322,44,482013106001,83800.0,29.737128139812235,-95.3215195334901,297,13,23,20,12
362,396,397,1919,685,1919,1754,165,159,110,28,6,15,0,0,6,1394,1251,143,139,103,22,0,14,0,0,4,685,598,87,482013106002,96900.0,29.731937582982045,-95.32268323445352,298,14,23,21,13
363,397,398,814,321,814,721,93,89,56,30,0,1,0,2,4,595,512,83,79,50,26,0,1,0,2,4,321,283,38,482013106003,137500.0,29.73369156923143,-95.32719653268283,344,14,21,22,14
364,398,399,1014,379,1014,925,89,86,61,21,0,4,0,0,3,726,648,78,76,56,17,0,3,0,0,2,379,311,68,482013106004,117100.0,29.72655001579386,-95.3271996778865,321,15,21,21,13
365,399,400,1260,477,1260,1063,197,192,136,27,0,28,0,1,5,914,735,179,174,129,21,0,24,0,0,5,477,414,63,482013106005,113500.0,29.7287252155988,-95.33022830415123,341,14,21,21,13
366,400,401,1948,659,1948,1782,166,164,103,32,0,29,0,0,2,1356,1212,144,142,90,27,0,25,0,0,2,659,560,99,482013107001,96500.0,29.72329880245183,-95.3213429959575,280,15,23,19,12
367,401,402,2219,839,2219,1672,547,531,476,32,6,16,0,1,16,1645,1149,496,485,435,29,4,16,0,1,11,839,749,90,482013107002,200000.0,29.7195055000154,-95.31224733615998,230,12,17,13,10
368,402,403,1353,504,1353,1297,56,55,22,32,0,1,0,0,1,878,841,37,36,15,20,0,1,0,0,1,504,410,94,482013108001,94400.0,29.73099366022416,-95.3091621966142,228,11,16,10,10
369,403,404,1137,520,1137,1012,125,122,110,8,0,2,0,2,3,769,656,113,112,102,6,0,2,0,2,1,520,336,184,482013108002,153400.0,29.72832048301654,-95.31485400254095,246,11,20,16,11
370,404,405,838,272,838,809,29,29,16,9,0,0,1,3,0,537,519,18,18,13,4,0,0,1,0,0,272,235,37,482013109001,74100.0,29.73547153338705,-95.29426381006732,159,11,13,5,9
371,405,406,1597,521,1597,1528,69,67,46,10,0,10,0,1,2,1088,1024,64,64,44,10,0,9,0,1,0,521,463,58,482013109002,89100.0,29.73082979222288,-95.2965867621824,166,11,13,5,9
372,406,407,1009,488,1009,901,108,102,53,42,2,0,1,4,6,760,657,103,97,50,41,2,0,1,3,6,488,388,100,482013109003,94400.0,29.73601051783788,-95.29998211956956,184,12,14,5,9
373,407,408,907,305,907,880,27,27,12,12,0,3,0,0,0,609,585,24,24,9,12,0,3,0,0,0,305,277,28,482013109004,,29.737258282671817,-95.30807471806028,226,10,15,9,10
374,408,409,1419,529,1419,1374,45,44,34,5,4,1,0,0,1,1032,988,44,44,34,5,4,1,0,0,0,529,430,99,482013109005,71500.0,29.7399634227383,-95.30612808710922,211,10,15,10,10
375,409,410,1078,392,1078,1059,19,19,12,4,1,1,0,1,0,749,731,18,18,12,4,1,1,0,0,0,392,318,74,482013110001,75200.0,29.743021998094537,-95.29122486101338,137,11,12,6,8
376,410,411,1076,385,1076,1015,61,58,38,6,6,6,0,2,3,776,725,51,49,35,4,3,6,0,1,2,385,335,50,482013110002,79400.0,29.748441681379376,-95.2987430073592,173,11,13,6,9
377,411,412,1588,523,1588,1553,35,35,29,4,0,1,0,1,0,1073,1040,33,33,28,3,0,1,0,1,0,523,468,55,482013110003,82800.0,29.74255987322751,-95.2964265686885,163,11,12,6,9
378,412,413,1442,474,1442,1411,31,29,18,9,1,1,0,0,2,997,972,25,23,16,5,1,1,0,0,2,474,416,58,482013110004,59300.0,29.74911595470916,-95.30344199138896,186,11,15,9,9
379,413,414,1927,700,1927,1875,52,52,36,13,0,0,0,3,0,1399,1350,49,49,34,13,0,0,0,2,0,700,589,111,482013110005,86600.0,29.74277068677004,-95.3042375626843,192,11,15,10,10
380,414,415,1170,449,1170,1145,25,25,19,2,0,4,0,0,0,829,808,21,21,17,2,0,2,0,0,0,449,372,77,482013111001,65200.0,29.73792553519121,-95.2835103613017,125,8,11,6,7
381,415,416,1191,385,1191,1143,48,48,40,5,2,1,0,0,0,822,783,39,39,34,4,0,1,0,0,0,385,342,43,482013111002,79400.0,29.72764456297969,-95.29050369917556,137,12,13,5,8
382,416,417,1589,557,1589,1536,53,48,41,2,2,1,0,2,5,1123,1082,41,39,34,2,2,1,0,0,2,557,492,65,482013111003,76600.0,29.72725012259881,-95.28484575465332,126,10,11,4,8
383,417,418,1936,687,1936,1868,68,62,28,21,3,7,0,3,6,1360,1310,50,46,21,17,2,5,0,1,4,687,589,98,482013111004,69900.0,29.73276669874005,-95.2856357038767,130,9,12,4,8
384,418,419,1736,556,1736,1626,110,102,86,6,1,6,0,3,8,1214,1119,95,91,76,5,1,6,0,3,4,556,505,51,482013112001,88300.0,29.72094463384279,-95.2916444975475,143,12,13,5,8
385,419,420,2004,676,2004,1893,111,109,93,12,1,0,0,3,2,1397,1306,91,91,78,10,1,0,0,2,0,676,616,60,482013112002,88700.0,29.719830176613414,-95.2970744228338,172,12,13,5,9
386,420,421,1168,537,1168,1011,157,157,124,32,0,0,1,0,0,877,738,139,139,106,32,0,0,1,0,0,537,399,138,482013112003,127200.0,29.71828516917069,-95.30330164081046,184,12,16,8,9
387,421,422,1686,546,1686,1582,104,103,80,16,3,4,0,0,1,1211,1121,90,89,70,12,3,4,0,0,1,546,489,57,482013113001,86900.0,29.71379580472324,-95.29120431998336,141,12,13,5,8
388,422,423,1586,471,1586,1486,100,100,75,10,5,7,0,3,0,1102,1012,90,90,71,9,3,7,0,0,0,471,436,35,482013113002,86700.0,29.707235313968845,-95.2929203424414,151,11,12,5,9
389,423,424,1970,570,1970,1861,109,97,82,11,2,2,0,0,12,1302,1197,105,95,80,11,2,2,0,0,10,570,522,48,482013113003,83600.0,29.70752420271004,-95.298739990346,176,11,13,5,9
390,424,425,1496,572,1496,1275,221,220,48,167,2,3,0,0,1,1026,841,185,184,40,139,2,3,0,0,1,572,470,102,482013114001,66700.0,29.719240682237533,-95.27503231597107,85,10,9,2,4
391,425,426,2067,700,2067,1731,336,334,76,50,1,199,1,7,2,1441,1179,262,260,60,36,1,158,1,4,2,700,618,82,482013115001,63300.0,29.708899290946096,-95.27646152564192,90,9,10,3,4
392,426,427,1337,441,1337,1200,137,134,74,31,0,29,0,0,3,932,806,126,123,68,30,0,25,0,0,3,441,404,37,482013115002,89300.0,29.704078160730862,-95.28967831550116,139,11,12,5,8
393,427,428,2249,644,2249,2150,99,93,84,3,1,5,0,0,6,1564,1479,85,80,72,3,1,4,0,0,5,644,596,48,482013115003,81900.0,29.71144943050738,-95.28425130797793,131,9,11,4,7
394,428,429,1958,572,1958,1885,73,72,61,4,0,3,0,4,1,1390,1321,69,68,57,4,0,3,0,4,1,572,521,51,482013115004,106600.0,29.70654255441136,-95.28366701172207,129,9,10,5,7
395,429,430,1287,447,1287,1213,74,68,15,46,0,5,0,2,6,837,784,53,49,9,36,0,4,0,0,4,447,373,74,482013116001,,29.703427743317533,-95.287035082058,135,9,11,4,8
396,430,431,2185,839,2185,2076,109,102,17,78,1,3,0,3,7,1412,1325,87,83,15,62,1,2,0,3,4,839,687,152,482013116002,,29.70142860892465,-95.28723268803024,136,6,11,4,8
397,432,433,3085,1127,3085,2380,705,692,137,490,0,62,0,3,13,2117,1560,557,548,122,371,0,54,0,1,9,1127,1010,117,482013117001,83200.0,29.700578232336337,-95.30024789555044,175,9,11,5,9
398,433,434,2508,700,2508,2299,209,197,124,62,2,4,0,5,12,1677,1501,176,169,113,48,2,4,0,2,7,700,658,42,482013117002,78500.0,29.699271527003912,-95.31500416948468,218,8,16,16,11
399,434,435,1456,413,1456,1378,78,78,69,5,0,2,0,2,0,994,928,66,66,58,4,0,2,0,2,0,413,385,28,482013118001,78600.0,29.704552116950715,-95.31609487677542,234,12,18,17,11
400,435,436,1759,541,1759,1627,132,130,93,21,7,2,0,7,2,1203,1090,113,111,87,16,2,1,0,5,2,541,477,64,482013118002,87500.0,29.705845731923464,-95.3247826039474,269,15,19,20,13
401,436,437,1327,399,1327,1265,62,60,39,13,1,7,0,0,2,872,820,52,51,35,9,1,6,0,0,1,399,368,31,482013118003,320000.0,29.708997180333675,-95.3101499978177,214,12,16,11,10
402,437,438,1040,338,1040,941,99,93,61,23,1,8,0,0,6,718,631,87,82,54,19,1,8,0,0,5,338,299,39,482013119001,87300.0,29.71310236459924,-95.31718658907248,252,12,22,18,11
403,438,439,1408,432,1408,1257,151,146,92,29,0,23,0,2,5,989,864,125,120,79,22,0,19,0,0,5,432,398,34,482013119002,77400.0,29.718626793017396,-95.3291304045112,332,15,20,21,14
404,439,440,1444,731,1444,185,1259,1223,520,486,4,210,1,2,36,1364,174,1190,1163,495,457,4,204,1,2,27,731,635,96,482013120001,328800.0,29.719411942794487,-95.33956490524132,413,14,20,21,17
405,440,441,2645,720,2645,214,2431,2376,797,1179,8,380,5,7,55,2527,205,2322,2271,782,1089,8,380,5,7,51,720,632,88,482013120002,192000.0,29.71404729815428,-95.35070210341937,420,14,20,21,18
406,441,442,2725,12,2725,389,2336,2326,924,830,13,476,0,83,10,2706,386,2320,2310,918,820,13,476,0,83,10,12,11,1,482013121001,,29.722278962980507,-95.34461201657676,420,14,21,21,18
407,442,443,713,381,713,115,598,594,12,579,0,3,0,0,4,511,63,448,444,10,431,0,3,0,0,4,381,272,109,482013122001,81700.0,29.732796509825388,-95.34787702682584,469,13,21,22,20
408,443,444,683,407,683,183,500,494,25,467,0,2,0,0,6,517,108,409,406,22,382,0,2,0,0,3,407,272,135,482013122002,105900.0,29.72931675776199,-95.34784126131534,433,13,21,21,18
409,444,445,662,404,662,105,557,556,8,543,0,4,0,1,1,509,66,443,443,8,430,0,4,0,1,0,404,268,136,482013122003,63600.0,29.73314871421544,-95.35375224904726,476,13,21,22,21
410,445,446,773,452,773,202,571,565,105,418,0,42,0,0,6,625,134,491,486,104,343,0,39,0,0,5,452,331,121,482013123001,196300.0,29.73927685668198,-95.3628187827586,509,13,25,25,21
411,446,447,1189,690,1189,182,1007,1003,29,964,0,7,1,2,4,928,121,807,805,24,771,0,7,1,2,2,690,514,176,482013123002,170700.0,29.73593664561012,-95.35752632084078,493,13,24,22,21
412,447,448,767,455,767,190,577,573,36,524,0,13,0,0,4,582,120,462,459,36,410,0,13,0,0,3,455,331,124,482013124001,151000.0,29.73295302269777,-95.3670347266464,499,13,25,22,22
413,448,449,657,373,657,59,598,596,22,569,0,5,0,0,2,491,36,455,453,20,428,0,5,0,0,2,373,250,123,482013124002,81200.0,29.729237193203133,-95.360994338024,452,13,26,21,20
414,449,450,784,523,784,33,751,744,24,710,0,9,0,1,7,625,24,601,596,24,564,0,7,0,1,5,523,373,150,482013124003,32700.0,29.726898074133675,-95.35400967798668,435,14,21,21,19
415,450,451,2499,913,2499,333,2166,2122,1011,888,5,211,0,7,44,2260,281,1979,1949,959,788,5,193,0,4,30,913,860,53,482013125001,232400.0,29.74310888949592,-95.36996802327448,525,14,25,25,22
416,451,452,1736,905,1736,421,1315,1288,683,505,5,91,0,4,27,1604,346,1258,1236,665,473,5,89,0,4,22,905,762,143,482013125002,242900.0,29.73616842118682,-95.37644091503456,542,15,24,22,22
417,452,453,2336,1784,2336,306,2030,1977,1363,298,3,306,1,6,53,2138,260,1878,1836,1290,252,3,287,1,3,42,1784,1425,359,482013126001,365600.0,29.721795694747748,-95.38460583030394,505,16,24,22,24
418,453,454,960,1219,960,136,824,794,326,386,0,82,0,0,30,865,119,746,720,314,330,0,76,0,0,26,1219,564,655,482013126002,118800.0,29.722842371317324,-95.37949575447789,490,15,25,21,21
419,454,455,901,495,901,279,622,612,198,348,3,57,0,6,10,695,187,508,501,159,290,2,48,0,2,7,495,384,111,482013126003,218400.0,29.730549415888117,-95.37635867069858,507,15,24,21,22
420,455,456,1674,789,1674,275,1399,1366,742,516,6,99,1,2,33,1465,206,1259,1238,687,459,6,85,1,0,21,789,658,131,482013126004,324000.0,29.725806212171296,-95.3830549514656,502,16,25,21,23
421,456,457,580,353,580,32,548,546,9,530,0,5,0,2,2,467,28,439,437,8,422,0,5,0,2,2,353,258,95,482013127001,183800.0,29.724800143099667,-95.3651190453019,450,13,26,21,19
422,457,458,822,527,822,64,758,735,32,689,1,12,0,1,23,668,39,629,616,29,573,1,12,0,1,13,527,393,134,482013127002,173800.0,29.7266729412935,-95.36858147601346,457,13,26,21,20
423,458,459,553,329,553,40,513,506,36,465,1,2,0,2,7,461,32,429,424,36,383,1,2,0,2,5,329,269,60,482013127003,123400.0,29.72887216719441,-95.37089102013472,467,13,26,21,20
424,459,460,1364,548,1364,129,1235,1227,10,1215,1,0,1,0,8,895,68,827,819,7,810,1,0,1,0,8,548,493,55,482013128001,,29.72272265723189,-95.36049289849412,447,13,26,21,20
425,460,461,968,180,968,17,951,940,11,925,2,1,1,0,11,899,10,889,878,11,863,2,1,1,0,11,180,162,18,482013128002,104600.0,29.72105339152724,-95.35489648739792,433,14,21,21,19
426,461,462,2725,1412,2725,119,2606,2574,68,2463,6,28,0,9,32,2327,83,2244,2218,64,2112,6,27,0,9,26,1412,1113,299,482013129001,144600.0,29.713635634821856,-95.36063375561108,436,13,25,21,20
427,462,463,1216,690,1216,50,1166,1152,66,1074,4,7,0,1,14,1022,36,986,974,60,903,3,7,0,1,12,690,570,120,482013129002,205900.0,29.715746699681432,-95.36617115378743,440,13,25,21,20
428,463,464,712,435,712,28,684,654,42,606,0,4,0,2,30,564,23,541,528,42,480,0,4,0,2,13,435,331,104,482013130001,191100.0,29.72183767951308,-95.37441749139734,475,15,24,22,20
429,464,465,909,535,909,98,811,797,90,685,2,18,0,2,14,739,71,668,659,86,553,2,18,0,0,9,535,424,111,482013130002,183300.0,29.71599633776853,-95.37427777687276,465,15,24,22,20
430,465,466,728,491,728,35,693,684,32,637,1,9,0,5,9,607,27,580,576,29,537,1,8,0,1,4,491,363,128,482013130003,190100.0,29.720632263931964,-95.36961199846093,454,13,25,21,20
431,466,467,2789,1514,2789,336,2453,2401,1603,520,3,266,2,7,52,2627,307,2320,2277,1535,478,3,252,2,7,43,1514,1286,228,482013131001,288900.0,29.712351309736203,-95.38624415767696,492,17,25,22,24
432,467,468,567,382,567,55,512,502,242,46,1,208,2,3,10,483,43,440,435,218,40,1,171,2,3,5,382,270,112,482013131002,360300.0,29.707599884368825,-95.39755216917436,495,15,22,25,27
433,468,469,857,488,857,30,827,822,80,713,1,27,1,0,5,711,19,692,687,76,588,1,21,1,0,5,488,378,110,482013132001,295800.0,29.70808072643769,-95.3492004279128,398,14,19,21,18
434,469,470,541,345,541,26,515,509,22,482,0,5,0,0,6,414,13,401,397,16,377,0,4,0,0,4,345,221,124,482013132002,99000.0,29.703849948306377,-95.352695120855,390,14,19,21,18
435,470,471,1540,814,1540,303,1237,1210,57,1122,10,19,0,2,27,1184,201,983,959,52,884,5,18,0,0,24,814,668,146,482013132003,138800.0,29.705923590796733,-95.37023342600544,423,13,24,21,20
436,471,472,860,424,860,28,832,820,69,742,2,5,0,2,12,720,21,699,691,63,620,2,5,0,1,8,424,365,59,482013132004,215900.0,29.708502893861937,-95.36614402232236,419,13,24,21,20
437,472,473,1172,523,1172,188,984,975,31,939,2,2,0,1,9,841,112,729,724,26,693,2,2,0,1,5,523,445,78,482013133001,76700.0,29.701912490359685,-95.33191864080486,310,12,18,21,13
438,473,474,1482,638,1482,173,1309,1303,44,1257,1,0,0,1,6,1187,114,1073,1067,36,1030,1,0,0,0,6,638,576,62,482013133002,83900.0,29.706193887627304,-95.33863852280562,380,14,19,21,17
439,474,475,1177,509,1177,326,851,838,17,818,0,3,0,0,13,874,210,664,653,16,634,0,3,0,0,11,509,449,60,482013134001,67100.0,29.697502206062136,-95.34495831325636,340,10,18,21,18
440,475,476,1758,930,1758,374,1384,1375,37,1317,8,10,0,3,9,1329,210,1119,1113,29,1067,7,9,0,1,6,930,685,245,482013134002,69200.0,29.692423512394896,-95.33466522510128,292,11,18,21,16
441,476,477,833,334,833,146,687,681,4,672,0,5,0,0,6,627,91,536,530,4,521,0,5,0,0,6,334,295,39,482013135001,53300.0,29.69255983912431,-95.34456406813209,324,10,18,21,18
442,477,478,996,423,996,162,834,827,16,809,0,0,0,2,7,712,103,609,604,15,588,0,0,0,1,5,423,349,74,482013135002,61700.0,29.69062335170096,-95.34838848829376,325,10,18,21,18
443,478,479,672,269,672,182,490,485,6,478,1,0,0,0,5,463,104,359,355,4,350,1,0,0,0,4,269,212,57,482013135003,62900.0,29.685707923793057,-95.34932107839518,295,11,16,21,16
444,479,480,1173,470,1173,478,695,695,33,649,7,3,0,3,0,882,302,580,580,30,543,4,3,0,0,0,470,412,58,482013136001,51700.0,29.698360067415894,-95.35571246282844,366,10,20,21,19
445,480,481,1940,690,1940,166,1774,1749,13,1734,2,0,0,0,25,1217,108,1109,1103,12,1089,2,0,0,0,6,690,619,71,482013136002,75000.0,29.68479661891174,-95.3613766932643,300,10,21,21,17
446,481,482,1718,707,1718,592,1126,1112,28,1065,0,19,0,0,14,1279,377,902,893,26,852,0,15,0,0,9,707,596,111,482013136003,84400.0,29.690747683890397,-95.35611593128328,331,10,20,21,19
447,482,483,953,383,953,23,930,921,8,906,2,3,0,2,9,725,16,709,708,8,694,2,2,0,2,1,383,353,30,482013137001,52600.0,29.69380512931295,-95.36546402545164,350,9,23,21,19
448,483,484,1504,640,1504,169,1335,1323,24,1294,0,5,0,0,12,1188,111,1077,1068,23,1040,0,5,0,0,9,640,576,64,482013137002,70200.0,29.6992341220561,-95.36693698927986,393,9,23,21,20
449,484,485,1235,442,1235,67,1168,1166,11,1140,2,12,0,1,2,630,37,593,591,11,569,1,9,0,1,2,442,399,43,482013138001,44500.0,29.690329717855203,-95.369470319217,349,9,23,21,20
450,485,486,753,449,753,38,715,710,6,702,2,0,0,0,5,626,25,601,596,6,588,2,0,0,0,5,449,381,68,482013138002,46000.0,29.68610415791165,-95.36965955617556,323,10,21,21,18
451,486,487,678,347,678,225,453,446,8,415,2,7,7,7,7,478,123,355,352,8,324,2,7,7,4,3,347,250,97,482013138003,64300.0,29.68293841705236,-95.37378510786944,313,11,20,22,16
452,487,488,2108,796,2108,137,1971,1948,14,1923,5,3,0,3,23,1368,85,1283,1272,8,1255,3,3,0,3,11,796,742,54,482013138004,57600.0,29.69060139220384,-95.37540924772505,375,10,22,22,20
453,488,489,1943,1181,1943,272,1671,1609,668,651,3,284,2,1,62,1676,214,1462,1415,615,529,3,265,2,1,47,1181,979,202,482013139001,120800.0,29.69450251830448,-95.38317881638692,398,11,22,22,23
454,489,490,1635,1046,1635,158,1477,1433,524,469,1,430,0,9,44,1457,137,1320,1283,475,413,1,387,0,7,37,1046,918,128,482013139002,118100.0,29.683137188975174,-95.38383571640638,342,12,20,22,19
455,490,491,917,657,917,104,813,796,260,333,3,199,0,1,17,835,89,746,732,250,293,3,185,0,1,14,657,571,86,482013139003,55000.0,29.683141474095663,-95.38948380584816,351,12,20,23,20
456,491,492,25,24,25,7,18,17,5,0,0,12,0,0,1,25,7,18,17,5,0,0,12,0,0,1,24,15,9,482013140011,,29.700857406769924,-95.39310671002734,461,12,22,25,25
457,492,493,668,402,668,53,615,600,224,124,0,252,0,0,15,613,47,566,552,216,104,0,232,0,0,14,402,353,49,482013140012,82100.0,29.69050208795654,-95.39172104450692,405,11,22,25,25
458,493,494,2066,1402,2066,207,1859,1770,705,393,9,658,0,5,89,1879,192,1687,1613,664,349,8,588,0,4,74,1402,1238,164,482013140013,124700.0,29.695598391285092,-95.39019965714871,414,11,22,25,24
459,494,495,1493,903,1493,143,1350,1329,254,533,0,529,1,12,21,1373,130,1243,1224,241,467,0,503,1,12,19,903,824,79,482013140021,,29.686712961593837,-95.397731290282,398,11,21,25,25
460,495,496,1029,667,1029,114,915,897,291,156,1,436,4,9,18,947,109,838,821,275,145,0,389,4,8,17,667,537,130,482013140022,,29.68874950844493,-95.40158682508796,421,11,22,24,27
461,496,497,1217,914,1217,120,1097,1068,506,194,0,368,0,0,29,1095,101,994,971,487,164,0,320,0,0,23,914,767,147,482013140023,93800.0,29.683534038338063,-95.39690608242675,373,12,20,25,23
462,497,498,1155,701,1155,140,1015,999,249,267,1,479,1,2,16,1045,126,919,905,215,246,1,440,1,2,14,701,670,31,482013140024,,29.68381374941665,-95.39776624204416,374,12,20,25,23
463,498,499,2650,1185,2650,246,2404,2371,548,378,1,1440,2,2,33,2425,232,2193,2163,527,317,0,1315,2,2,30,1185,1127,58,482013140025,,29.69275625901895,-95.39648470434643,428,11,22,25,26
464,499,500,962,607,962,84,878,866,55,758,2,49,0,2,12,731,61,670,662,51,567,2,41,0,1,8,607,506,101,482013143001,47300.0,29.679705704697803,-95.42267125429451,390,12,17,25,25
465,500,501,1059,615,1059,112,947,939,63,832,1,43,0,0,8,841,79,762,758,55,664,1,38,0,0,4,615,588,27,482013143002,,29.686629558488203,-95.41650246166748,431,12,21,25,27
466,501,502,1941,1254,1941,196,1745,1723,82,1578,7,54,1,1,22,1543,149,1394,1378,78,1243,7,48,1,1,16,1254,999,255,482013143003,60900.0,29.679976633252853,-95.41580840149572,374,13,18,25,24
467,502,503,1216,1003,1216,125,1091,1049,448,112,0,483,1,5,42,1040,106,934,906,419,104,0,379,1,3,28,1003,699,304,482013144001,81600.0,29.696054273953205,-95.40908774369753,463,11,22,24,28
468,503,504,1877,1324,1877,208,1669,1618,691,117,0,805,1,4,51,1656,186,1470,1429,644,109,0,674,1,1,41,1324,1092,232,482013144002,153200.0,29.68861155709789,-95.40687074605714,438,11,22,24,27
469,504,505,1872,727,1872,1662,210,203,103,88,5,7,0,0,7,1262,1089,173,167,84,72,4,7,0,0,6,727,609,118,482013201001,93700.0,29.69730779570228,-95.28193917170952,122,5,8,4,6
470,505,506,1004,341,1004,863,141,136,63,28,0,45,0,0,5,692,581,111,107,57,19,0,31,0,0,4,341,299,42,482013201002,76700.0,29.691415349292527,-95.2804533837619,115,5,8,3,7
471,506,507,2205,689,2205,2035,170,162,96,53,4,5,0,4,8,1476,1337,139,133,83,41,3,5,0,1,6,689,627,62,482013202001,103000.0,29.70224228826863,-95.26891508069868,73,4,7,2,4
472,507,508,931,326,931,817,114,114,81,27,1,4,0,1,0,566,474,92,92,69,17,1,4,0,1,0,326,267,59,482013202002,,29.692972924561865,-95.2620272375455,67,4,6,2,4
473,508,509,1284,480,1284,528,756,743,146,23,8,565,0,1,13,964,364,600,589,136,21,7,424,0,1,11,480,421,59,482013202003,83300.0,29.686666108315844,-95.2703765045587,80,4,6,1,5
474,509,510,2242,751,2242,1715,527,520,172,56,3,281,0,8,7,1531,1123,408,402,153,42,2,200,0,5,6,751,671,80,482013202004,102500.0,29.69324702185592,-95.2729464489434,77,4,6,1,4
475,510,511,2413,653,2413,2149,264,261,240,13,5,3,0,0,3,1602,1371,231,230,213,10,4,3,0,0,1,653,618,35,482013205001,83500.0,29.69905013635136,-95.24553430615592,52,3,4,6,4
476,511,512,2205,577,2205,1972,233,221,206,7,3,5,0,0,12,1460,1270,190,183,176,2,2,3,0,0,7,577,545,32,482013205002,80600.0,29.696151883772387,-95.243319077303,49,3,4,5,4
477,512,513,2638,863,2638,2347,291,284,239,24,0,18,0,3,7,1771,1519,252,248,210,23,0,14,0,1,4,863,777,86,482013206011,85900.0,29.684062345941264,-95.26222389038816,74,5,6,2,6
478,513,514,1401,624,1401,1169,232,225,70,148,0,6,0,1,7,996,791,205,198,64,128,0,6,0,0,7,624,492,132,482013206021,78400.0,29.6725049649451,-95.26221018274298,73,6,7,2,6
479,514,515,1496,409,1496,1379,117,113,100,7,0,6,0,0,4,974,876,98,96,86,5,0,5,0,0,2,409,370,39,482013206022,57800.0,29.68074504999105,-95.25463930856728,67,6,4,3,6
480,515,516,1640,469,1640,1505,135,132,93,15,1,23,0,0,3,1130,1010,120,119,85,14,0,20,0,0,1,469,424,45,482013206023,86300.0,29.67933407805534,-95.26040360223077,72,6,6,3,6
481,516,517,2723,1204,2723,1905,818,804,480,270,6,46,0,2,14,1896,1216,680,669,437,188,6,37,0,1,11,1204,935,269,482013207001,118300.0,29.677481579989312,-95.24516383882629,61,5,4,5,6
482,517,518,1126,418,1126,712,414,408,54,53,1,300,0,0,6,826,503,323,322,51,37,1,233,0,0,1,418,398,20,482013207002,102400.0,29.667836135880023,-95.25274560306605,66,6,5,3,6
483,518,519,1598,907,1598,765,833,822,125,665,2,21,7,2,11,1123,509,614,607,101,477,0,20,7,2,7,907,650,257,482013209001,96800.0,29.64432866705526,-95.2425725286589,56,4,4,6,4
484,519,520,1981,522,1981,1691,290,285,230,40,5,10,0,0,5,1287,1058,229,225,186,25,5,9,0,0,4,522,500,22,482013209002,85300.0,29.649591681324743,-95.2443954399006,58,4,4,6,4
485,520,521,1933,542,1933,1522,411,396,309,47,4,34,0,2,15,1327,988,339,338,271,35,3,28,0,1,1,542,531,11,482013209003,95500.0,29.64870686280484,-95.23488765245372,65,4,4,7,4
486,521,522,1882,515,1882,1509,373,368,290,36,1,39,1,1,5,1303,991,312,309,253,22,1,32,1,0,3,515,497,18,482013209004,91400.0,29.648843234435432,-95.22687069398896,63,4,5,6,4
487,522,523,1304,390,1304,1038,266,264,226,23,0,15,0,0,2,925,685,240,238,208,17,0,13,0,0,2,390,374,16,482013210001,86500.0,29.64432377214196,-95.224435395482,61,4,5,6,4
488,523,524,977,293,977,717,260,258,204,32,1,20,0,1,2,656,444,212,210,178,17,1,13,0,1,2,293,286,7,482013210002,89200.0,29.637899385015825,-95.21949988646033,62,4,5,6,5
489,524,525,1369,805,1369,923,446,435,113,280,1,41,0,0,11,887,558,329,324,95,201,1,27,0,0,5,805,484,321,482013210003,,29.63628668715605,-95.23442656192904,58,4,4,7,4
490,525,526,1203,385,1203,978,225,220,165,36,1,18,0,0,5,825,637,188,185,145,25,1,14,0,0,3,385,370,15,482013210004,94400.0,29.63276836367867,-95.22748391221916,66,4,4,6,5
491,526,527,2655,789,2655,2066,589,564,492,42,1,28,0,1,25,1818,1313,505,493,432,33,1,26,0,1,12,789,751,38,482013210005,94400.0,29.6406579916429,-95.23455826859728,58,4,4,7,4
492,527,528,3485,1530,3485,1960,1525,1492,561,647,11,264,5,4,33,2523,1305,1218,1199,479,497,7,209,3,4,19,1530,1399,131,482013211001,123900.0,29.6165562026082,-95.20586700020216,85,7,5,6,6
493,528,529,2934,892,2934,2109,825,807,495,132,4,167,0,9,18,1951,1301,650,639,416,87,2,131,0,3,11,892,854,38,482013211002,118900.0,29.628267760388336,-95.21435859579812,66,4,4,6,6
494,529,530,978,295,978,672,306,299,230,16,1,43,5,4,7,668,428,240,235,190,13,1,25,3,3,5,295,283,12,482013211003,79100.0,29.623771161490527,-95.20750568036117,57,4,4,6,6
495,530,531,1156,352,1156,868,288,276,135,124,0,17,0,0,12,672,491,181,178,106,59,0,13,0,0,3,352,337,15,482013212001,76800.0,29.64106174850352,-95.20286392268169,57,4,5,6,6
496,531,532,1475,425,1475,1320,155,155,144,10,1,0,0,0,0,940,808,132,132,124,7,1,0,0,0,0,425,406,19,482013212002,14000.0,29.632406599740705,-95.19997019309832,61,4,5,6,7
497,532,533,2122,838,2122,1710,412,402,126,249,1,26,0,0,10,1375,1072,303,300,114,164,1,21,0,0,3,838,715,123,482013213001,,29.650794240414776,-95.22001648400318,64,4,5,6,4
498,533,534,1746,753,1746,1313,433,427,150,264,8,4,0,1,6,1125,842,283,280,111,158,6,4,0,1,3,753,560,193,482013213002,155800.0,29.647233215100712,-95.21758376880486,65,4,5,6,5
499,534,535,1678,560,1678,1207,471,464,412,31,6,15,0,0,7,1232,801,431,425,387,22,3,13,0,0,6,560,503,57,482013213003,113300.0,29.644719859053147,-95.21172213480776,53,4,5,6,5
500,535,536,15,6,15,6,9,9,5,0,0,4,0,0,0,12,3,9,9,5,0,0,4,0,0,0,6,6,0,482013216003,113100.0,29.672816151494487,-95.2298174672394,59,5,6,4,5
501,536,537,1452,513,1452,962,490,488,470,10,0,7,1,0,2,1052,610,442,440,427,8,0,4,1,0,2,513,491,22,482013217001,117100.0,29.678933384577387,-95.24018678109802,62,5,4,5,6
502,537,538,1597,498,1597,1313,284,276,238,15,4,12,0,7,8,1098,839,259,254,222,14,4,9,0,5,5,498,463,35,482013217002,95600.0,29.677224888769494,-95.23190316083527,62,5,5,4,5
503,538,539,1943,531,1943,1725,218,217,185,27,2,3,0,0,1,1292,1103,189,189,169,16,1,3,0,0,0,531,500,31,482013218001,81700.0,29.690694615549507,-95.23814096119844,52,3,4,5,5
504,539,540,2165,625,2165,1889,276,272,231,22,2,12,0,5,4,1485,1243,242,241,211,16,1,9,0,4,1,625,600,25,482013218002,75700.0,29.685822110618396,-95.2391696496864,60,4,4,5,5
505,540,541,243,84,243,127,116,116,70,6,0,40,0,0,0,187,93,94,94,63,5,0,26,0,0,0,84,76,8,482013240002,147000.0,29.6252344814668,-95.1859570760518,74,5,6,6,5
506,544,545,1359,381,1359,803,556,543,13,507,0,21,0,2,13,947,529,418,411,12,379,0,19,0,1,7,381,368,13,482013301001,84900.0,29.639566141108133,-95.42623780889242,97,8,6,18,9
507,545,546,1706,490,1706,935,771,766,18,725,0,19,0,4,5,1177,617,560,556,14,521,0,19,0,2,4,490,477,13,482013301002,91200.0,29.635979021376308,-95.42565215289564,90,8,5,13,9
508,546,547,2674,649,2674,1678,996,979,16,946,0,16,0,1,17,1701,1043,658,653,12,625,0,15,0,1,5,649,631,18,482013301003,92500.0,29.630835441157107,-95.42583324682548,72,5,5,8,9
509,547,548,2574,812,2574,1328,1246,1243,41,1169,1,25,0,7,3,1783,816,967,966,36,902,1,24,0,3,1,812,752,60,482013301004,90700.0,29.63477305729819,-95.41652069292304,87,7,5,10,8
510,548,549,2388,703,2388,1261,1127,1118,77,1006,4,28,0,3,9,1610,771,839,836,61,744,4,26,0,1,3,703,656,47,482013302001,94300.0,29.64082329953593,-95.4531087956026,109,7,8,20,10
511,549,550,1855,667,1855,944,911,891,68,818,2,3,0,0,20,1328,613,715,702,61,636,2,3,0,0,13,667,624,43,482013302002,94800.0,29.633466187396635,-95.46054552922216,89,7,6,10,8
512,550,551,4489,1209,4489,2922,1567,1534,118,1243,10,159,2,2,33,2853,1789,1064,1044,85,827,2,128,2,0,20,1209,1172,37,482013303011,123900.0,29.63710492713081,-95.4702095603174,114,8,7,17,10
513,551,552,2680,635,2680,2089,591,579,106,374,0,93,0,6,12,1658,1255,403,398,74,247,0,74,0,3,5,635,626,9,482013303012,111700.0,29.633346047031,-95.47840437704248,92,9,6,7,6
514,552,553,2371,652,2371,1866,505,494,64,405,1,18,0,6,11,1543,1222,321,315,53,245,0,14,0,3,6,652,606,46,482013303021,101200.0,29.60971220220733,-95.47305936556668,54,5,3,3,5
515,553,554,1259,412,1259,538,721,713,95,613,0,4,1,0,8,929,342,587,580,87,488,0,4,1,0,7,412,386,26,482013303022,93000.0,29.61976809998465,-95.47001463453,82,5,3,6,6
516,554,555,1897,721,1897,733,1164,1146,61,1069,8,7,0,1,18,1358,449,909,898,53,835,5,4,0,1,11,721,574,147,482013303023,106100.0,29.62033200002081,-95.48169475506452,72,6,2,4,4
517,555,556,1467,564,1467,996,471,464,58,398,0,7,0,1,7,939,602,337,335,55,275,0,5,0,0,2,564,451,113,482013303031,105200.0,29.629838885799817,-95.49950571115566,74,5,5,2,5
518,556,557,1448,591,1448,734,714,702,152,539,5,6,0,0,12,1045,467,578,571,146,416,3,6,0,0,7,591,553,38,482013303032,119600.0,29.62254339271818,-95.50276753446134,76,5,3,2,6
519,557,558,1146,376,1146,259,887,886,17,852,0,17,0,0,1,831,169,662,661,15,632,0,14,0,0,1,376,373,3,482013303033,135300.0,29.63229539102129,-95.48745800563609,89,5,5,5,6
520,558,559,1270,355,1270,951,319,318,59,247,0,12,0,0,1,850,603,247,246,54,180,0,12,0,0,1,355,332,23,482013304001,79200.0,29.624064698604663,-95.45294344250271,96,4,3,6,9
521,559,560,1779,546,1779,1126,653,643,76,561,1,1,0,4,10,1212,720,492,488,65,421,1,1,0,0,4,546,503,43,482013304002,85000.0,29.618444496831657,-95.45685778404096,84,4,3,3,6
522,560,561,1614,601,1614,422,1192,1180,34,1123,3,11,0,9,12,1162,294,868,865,30,820,3,10,0,2,3,601,586,15,482013304003,85300.0,29.60994147915957,-95.455827360573,65,4,3,3,6
523,561,562,1582,442,1582,1129,453,444,66,372,5,1,0,0,9,993,649,344,337,51,280,5,1,0,0,7,442,416,26,482013305001,64600.0,29.62385663458598,-95.4231950496324,89,3,2,5,9
524,562,563,1468,416,1468,744,724,715,28,678,1,4,0,4,9,1052,508,544,536,25,505,0,4,0,2,8,416,394,22,482013305002,83100.0,29.623176738438627,-95.43329873690236,88,4,2,5,9
525,563,564,1071,346,1071,487,584,576,50,524,0,0,0,2,8,762,318,444,438,42,396,0,0,0,0,6,346,322,24,482013305003,72000.0,29.62375407213624,-95.44069975211588,90,4,2,6,8
526,564,565,1333,425,1333,589,744,739,27,710,1,1,0,0,5,943,393,550,546,22,522,1,1,0,0,4,425,403,22,482013306001,90900.0,29.61663724674961,-95.4245281212208,69,4,2,3,6
527,565,566,2095,709,2095,740,1355,1342,94,1174,2,72,0,0,13,1438,492,946,938,80,795,2,61,0,0,8,709,655,54,482013306002,89000.0,29.60997672741293,-95.43142621077,65,4,2,3,6
528,566,567,721,253,721,243,478,473,34,438,1,0,0,0,5,536,160,376,374,32,341,1,0,0,0,2,253,233,20,482013306003,92000.0,29.60972080124964,-95.44393721423596,66,4,2,3,5
529,567,568,2275,678,2275,919,1356,1341,76,1247,6,8,0,4,15,1611,594,1017,1006,69,924,3,8,0,2,11,678,642,36,482013306004,86000.0,29.6164817053615,-95.43859320432654,68,4,2,3,5
530,568,569,2189,578,2189,1390,799,787,42,740,3,2,0,0,12,1261,787,474,470,34,433,1,2,0,0,4,578,523,55,482013307001,73300.0,29.598067080799748,-95.450256049307,49,3,3,3,5
531,569,570,1700,493,1700,956,744,739,35,699,2,3,0,0,5,1213,656,557,554,20,530,1,3,0,0,3,493,471,22,482013307002,74100.0,29.601040038750384,-95.45554264537434,52,3,3,3,5
532,570,571,1542,439,1542,1126,416,406,33,363,2,7,0,1,10,1040,728,312,308,31,272,0,5,0,0,4,439,424,15,482013307003,97100.0,29.60275857078208,-95.46006865587414,54,4,4,3,5
533,571,572,2525,860,2525,1186,1339,1321,241,989,5,82,0,4,18,1721,743,978,970,209,692,4,62,0,3,8,860,788,72,482013308001,89000.0,29.60713389177881,-95.3288449457567,54,3,2,2,5
534,572,573,5,2,5,0,5,5,0,3,0,2,0,0,0,4,0,4,4,0,2,0,2,0,0,0,2,2,0,482013308002,122400.0,29.60683572524249,-95.38362456414302,56,2,2,3,4
535,573,574,5186,2131,5186,1137,4049,3976,451,3218,6,292,0,9,73,3752,752,3000,2960,408,2310,5,232,0,5,40,2131,2009,122,482013309001,115800.0,29.62142709211392,-95.3998774634314,87,3,2,6,8
536,574,575,1245,425,1245,762,483,475,101,356,1,17,0,0,8,822,475,347,340,86,241,1,12,0,0,7,425,347,78,482013309002,51000.0,29.607334518347788,-95.40168280004914,63,3,2,3,6
537,575,576,1455,405,1455,1144,311,306,124,179,0,0,0,3,5,871,646,225,223,97,124,0,0,0,2,2,405,375,30,482013309003,51600.0,29.60268171586847,-95.41652037734002,52,2,2,3,5
538,576,577,522,265,522,71,451,449,5,444,0,0,0,0,2,398,41,357,355,5,350,0,0,0,0,2,265,206,59,482013311001,48000.0,29.67262126995193,-95.35803205820054,233,9,17,20,15
539,577,578,545,212,545,93,452,449,12,437,0,0,0,0,3,417,69,348,347,11,336,0,0,0,0,1,212,182,30,482013311002,45200.0,29.67680972944232,-95.3609516461894,256,9,19,21,16
540,578,579,1427,577,1427,103,1324,1319,18,1293,3,4,0,1,5,931,60,871,869,13,851,3,1,0,1,2,577,505,72,482013311003,63800.0,29.6723784899044,-95.3773787304634,257,9,18,21,15
541,579,580,1349,607,1349,194,1155,1150,18,1128,1,2,1,0,5,982,119,863,860,16,840,1,2,1,0,3,607,507,100,482013311004,66800.0,29.67595230994768,-95.37077040500968,267,9,19,21,16
542,580,581,1661,750,1661,106,1555,1539,20,1511,1,3,1,3,16,1170,75,1095,1083,20,1055,1,3,1,3,12,750,633,117,482013312001,46600.0,29.663464330671065,-95.35959459552022,172,8,15,20,13
543,581,582,1812,913,1812,116,1696,1689,31,1655,2,0,0,1,7,1297,65,1232,1226,22,1202,1,0,0,1,6,913,792,121,482013312002,56300.0,29.663542945987828,-95.3743658742622,175,9,15,21,12
544,582,583,1419,551,1419,67,1352,1346,7,1335,3,1,0,0,6,1052,45,1007,1005,5,996,3,1,0,0,2,551,505,46,482013313001,52500.0,29.6521673150828,-95.38102644532002,108,6,12,20,8
545,583,584,945,407,945,100,845,840,3,835,0,2,0,0,5,735,58,677,674,2,671,0,1,0,0,3,407,360,47,482013313002,39000.0,29.648517026254467,-95.37152969368522,97,5,11,17,6
546,584,585,787,325,787,56,731,729,1,728,0,0,0,0,2,626,29,597,596,1,595,0,0,0,0,1,325,301,24,482013313003,60200.0,29.637312772184007,-95.38223945702786,65,6,4,13,5
547,585,586,1496,630,1496,95,1401,1396,4,1391,0,1,0,0,5,1170,50,1120,1117,4,1112,0,1,0,0,3,630,563,67,482013313004,62100.0,29.64692144028557,-95.37674838868408,99,6,9,18,6
548,586,587,2520,1098,2520,88,2432,2412,11,2371,3,26,0,1,20,1514,45,1469,1460,11,1424,1,23,0,1,9,1098,1011,87,482013314001,69400.0,29.65264463966672,-95.3624219519224,112,5,13,19,8
549,587,588,858,364,858,11,847,841,3,832,3,3,0,0,6,694,7,687,686,1,680,2,3,0,0,1,364,342,22,482013315001,71600.0,29.64419004546135,-95.36095569107694,78,5,7,17,7
550,588,589,732,318,732,34,698,695,0,695,0,0,0,0,3,583,14,569,568,0,568,0,0,0,0,1,318,283,35,482013315002,63200.0,29.63919206133717,-95.3596222985596,69,5,4,14,6
551,589,590,650,280,650,24,626,621,2,612,4,2,0,1,5,500,16,484,481,1,476,2,2,0,0,3,280,261,19,482013315003,61300.0,29.635000716197958,-95.35921377020853,65,5,4,10,6
552,590,591,1165,438,1165,40,1125,1122,6,1109,7,0,0,0,3,906,20,886,885,5,876,4,0,0,0,1,438,424,14,482013315004,72500.0,29.63106039106459,-95.36106146456147,60,3,4,8,9
553,591,592,820,324,820,30,790,784,1,778,3,2,0,0,6,656,20,636,634,1,628,3,2,0,0,2,324,309,15,482013315005,109600.0,29.62474340052741,-95.36049336653356,70,2,2,6,9
554,592,593,2920,1096,2920,641,2279,2253,210,1973,3,57,0,10,26,2091,393,1698,1683,188,1435,3,51,0,6,15,1096,1017,79,482013315006,91800.0,29.624548987343395,-95.37241846683672,62,2,2,6,7
555,593,594,2072,767,2072,125,1947,1944,14,1918,3,9,0,0,3,1562,69,1493,1492,13,1469,2,8,0,0,1,767,723,44,482013316011,90400.0,29.623241600069136,-95.34806670283888,69,2,1,5,9
556,594,595,2407,1069,2407,102,2305,2291,23,2261,1,6,0,0,14,1746,60,1686,1678,19,1654,1,4,0,0,8,1069,876,193,482013316012,83000.0,29.629888949344675,-95.3478947290059,60,3,1,8,9
557,595,596,1250,434,1250,214,1036,1027,9,1016,0,1,0,1,9,875,120,755,749,5,742,0,1,0,1,6,434,409,25,482013316013,77200.0,29.634701661066245,-95.35239599222552,59,6,2,10,6
558,596,597,729,268,729,37,692,689,0,684,2,2,0,1,3,574,28,546,543,0,539,1,2,0,1,3,268,257,11,482013316014,74600.0,29.634995957329814,-95.34426281198066,61,5,2,10,6
559,597,598,721,328,721,252,469,462,59,396,2,5,0,0,7,484,149,335,330,52,272,2,4,0,0,5,328,252,76,482013316021,14200.0,29.629351809181745,-95.31913140472098,44,3,2,7,7
560,598,599,1619,1283,1619,86,1533,1511,7,1502,1,0,0,1,22,1043,41,1002,988,7,979,1,0,0,1,14,1283,550,733,482013316022,104900.0,29.62901685572029,-95.335510261563,60,4,1,8,9
561,599,600,1676,599,1676,237,1439,1420,25,1388,3,1,0,3,19,1013,140,873,864,19,841,3,1,0,0,9,599,541,58,482013317001,76700.0,29.64396326626214,-95.32376950031194,48,6,4,16,5
562,600,601,945,341,945,85,860,857,5,849,3,0,0,0,3,721,44,677,674,5,666,3,0,0,0,3,341,320,21,482013317002,83100.0,29.63923256369874,-95.34316786027856,65,5,2,14,6
563,601,602,1350,552,1350,82,1268,1267,4,1260,1,2,0,0,1,1065,51,1014,1013,4,1006,1,2,0,0,1,552,507,45,482013317003,70300.0,29.6434708487359,-95.34907083080644,73,6,3,17,7
564,602,603,2652,1076,2652,228,2424,2402,34,2356,8,4,0,0,22,1824,135,1689,1673,26,1642,1,4,0,0,16,1076,911,165,482013318001,58000.0,29.65475193111525,-95.3462654495815,110,5,11,19,9
565,603,604,1030,353,1030,211,819,810,10,796,2,2,0,0,9,751,126,625,620,10,607,2,1,0,0,5,353,322,31,482013318002,67600.0,29.64882405982897,-95.34396360802066,96,5,7,17,7
566,604,605,895,392,895,53,842,836,5,823,2,4,0,2,6,680,30,650,646,4,634,2,4,0,2,4,392,339,53,482013319001,76500.0,29.66312159346059,-95.35240087834886,158,9,11,20,12
567,605,606,1406,503,1406,135,1271,1266,12,1245,5,2,0,2,5,1076,81,995,991,12,971,4,2,0,2,4,503,463,40,482013319002,63300.0,29.66401475682509,-95.3416098271681,151,8,13,20,12
568,606,607,1063,424,1063,85,978,975,12,963,0,0,0,0,3,771,52,719,717,10,707,0,0,0,0,2,424,372,52,482013319003,33200.0,29.66092514674064,-95.34414087169743,128,7,11,20,11
569,607,608,1821,620,1821,494,1327,1324,11,1310,0,3,0,0,3,1265,299,966,963,10,951,0,2,0,0,3,620,554,66,482013320001,58800.0,29.672366262379285,-95.34145173442369,204,8,14,20,13
570,608,609,849,291,849,186,663,653,14,633,0,0,0,6,10,636,117,519,511,11,494,0,0,0,6,8,291,263,28,482013320002,53600.0,29.667652069773148,-95.3434057912333,175,8,14,20,12
571,609,610,2356,842,2356,338,2018,1998,20,1904,1,72,0,1,20,1370,197,1173,1159,20,1097,1,40,0,1,14,842,713,129,482013320003,49600.0,29.673911456297358,-95.35019860942371,231,9,14,20,14
572,610,611,567,305,567,30,537,532,2,529,1,0,0,0,5,458,18,440,435,2,432,1,0,0,0,5,305,260,45,482013320004,84200.0,29.6731869248736,-95.35295471403316,227,9,14,20,14
573,611,612,1507,519,1507,757,750,746,16,727,1,2,0,0,4,1040,449,591,590,14,573,1,2,0,0,1,519,450,69,482013321001,45300.0,29.68102106887941,-95.34755795574505,262,10,14,21,13
574,612,613,1530,472,1530,714,816,812,23,783,0,2,0,4,4,1054,422,632,628,19,603,0,2,0,4,4,472,431,41,482013321002,63300.0,29.679599046075342,-95.34045794504492,241,10,14,21,12
575,613,614,1801,556,1801,881,920,912,16,881,3,8,1,3,8,1259,555,704,702,15,675,2,6,1,3,2,556,513,43,482013322001,46100.0,29.686631000236623,-95.33113105986084,231,11,17,21,12
576,614,615,2432,800,2432,842,1590,1579,22,1550,2,3,0,2,11,1734,495,1239,1231,17,1207,2,3,0,2,8,800,726,74,482013322002,58900.0,29.67789784401563,-95.32857085390184,156,11,14,21,10
577,615,616,752,267,752,264,488,486,14,472,0,0,0,0,2,542,159,383,382,12,370,0,0,0,0,1,267,231,36,482013322003,49100.0,29.682560071593574,-95.33766883107177,262,11,16,21,12
578,616,617,1319,451,1319,257,1062,1052,7,1034,7,2,2,0,10,996,153,843,839,5,827,4,2,1,0,4,451,427,24,482013323001,66100.0,29.669210788666,-95.32380923031134,102,9,15,19,9
579,617,618,1599,611,1599,414,1185,1180,27,1143,2,4,0,4,5,1192,257,935,931,18,904,1,4,0,4,4,611,537,74,482013323002,81200.0,29.66391373210917,-95.32319694071272,93,9,13,19,8
580,618,619,1368,508,1368,222,1146,1142,8,1128,0,0,0,6,4,1051,148,903,899,7,891,0,0,0,1,4,508,461,47,482013324001,57700.0,29.668360877471187,-95.3329459671926,134,9,14,20,10
581,619,620,1611,590,1611,202,1409,1396,23,1371,0,0,0,2,13,1238,110,1128,1122,18,1103,0,0,0,1,6,590,555,35,482013324002,73600.0,29.661717308132573,-95.33265931758189,110,8,11,20,9
582,620,621,1292,426,1292,133,1159,1148,30,1104,6,8,0,0,11,1069,113,956,945,29,906,3,7,0,0,11,426,407,19,482013324003,67100.0,29.65457562864958,-95.3268710789326,73,6,12,19,5
583,621,622,2024,646,2024,850,1174,1171,100,1058,4,1,0,8,3,1437,512,925,923,94,818,3,1,0,7,2,646,613,33,482013325001,74400.0,29.66105853135561,-95.31289078480847,72,5,8,13,7
584,622,623,1233,435,1233,634,599,597,81,508,2,6,0,0,2,934,419,515,515,75,434,2,4,0,0,0,435,403,32,482013325002,77800.0,29.66762768523225,-95.3034023788574,82,6,10,7,6
585,623,624,1351,361,1351,1227,124,124,89,30,0,5,0,0,0,924,817,107,107,79,24,0,4,0,0,0,361,342,19,482013326001,72700.0,29.67999168247582,-95.30125719239778,120,8,7,6,7
586,624,625,2335,820,2335,1491,844,840,100,697,12,29,0,2,4,1705,989,716,712,89,588,8,25,0,2,4,820,796,24,482013326002,82300.0,29.676271335999257,-95.29720304496452,102,7,7,5,8
587,625,626,1650,472,1650,900,750,745,55,674,5,5,1,5,5,1103,525,578,573,54,506,5,5,1,2,5,472,449,23,482013326003,84200.0,29.673900039255354,-95.31361484463942,116,6,12,14,9
588,626,627,1269,445,1269,512,757,750,19,728,1,0,0,2,7,874,304,570,567,17,547,1,0,0,2,3,445,421,24,482013326004,87100.0,29.6718199321066,-95.30544994683312,90,6,9,8,8
589,627,628,843,265,843,776,67,65,48,14,0,3,0,0,2,556,498,58,56,41,12,0,3,0,0,2,265,242,23,482013327001,82500.0,29.683241067830924,-95.30034559281364,132,8,9,5,7
590,628,629,1885,559,1885,1690,195,193,115,65,2,10,0,1,2,1323,1161,162,160,100,50,2,7,0,1,2,559,521,38,482013327002,78100.0,29.68543658448712,-95.31665651476848,173,8,15,18,10
591,629,630,1163,423,1163,938,225,224,76,139,2,6,0,1,1,794,594,200,199,72,119,1,6,0,1,1,423,315,108,482013328001,56800.0,29.69390987106124,-95.31499495667128,201,8,16,16,11
592,630,631,1226,418,1226,1129,97,94,52,38,2,2,0,0,3,817,732,85,82,44,34,2,2,0,0,3,418,364,54,482013328002,87500.0,29.69482142679321,-95.30454600429256,176,8,12,9,10
593,631,632,2228,655,2228,1888,340,335,66,263,0,5,0,1,5,1453,1234,219,216,58,153,0,5,0,0,3,655,595,60,482013328003,87700.0,29.68946698854251,-95.30490069169365,166,8,12,9,10
594,632,633,2352,721,2352,2207,145,139,96,39,3,1,0,0,6,1517,1390,127,124,87,35,1,1,0,0,3,721,622,99,482013329001,86000.0,29.69309918942705,-95.294046566871,149,7,10,5,9
595,633,634,2697,781,2697,2267,430,418,248,134,4,29,1,2,12,1894,1508,386,380,222,124,4,27,1,2,6,781,697,84,482013329002,80300.0,29.688740621664223,-95.28823472667824,125,7,10,4,8
596,634,635,2530,752,2530,2187,343,341,232,69,0,40,0,0,2,1775,1476,299,297,206,52,0,39,0,0,2,752,705,47,482013330001,89000.0,29.681951982269283,-95.28911358855731,103,9,8,4,6
597,635,636,785,311,785,670,115,111,90,12,2,7,0,0,4,549,439,110,109,88,12,2,7,0,0,1,311,238,73,482013330002,152700.0,29.681076716227192,-95.28050175713058,91,7,8,4,7
598,636,637,1548,560,1548,877,671,664,123,509,0,30,0,2,7,1070,569,501,495,110,366,0,19,0,0,6,560,494,66,482013331001,91300.0,29.674868393370584,-95.28442073817962,87,7,7,4,6
599,637,638,2115,834,2115,753,1362,1349,172,184,0,985,0,8,13,1534,509,1025,1017,158,143,0,708,0,8,8,834,744,90,482013331002,79300.0,29.676007656714216,-95.27537544676308,82,7,6,2,6
600,638,639,1862,710,1862,1294,568,563,87,412,1,55,0,8,5,1287,854,433,431,70,309,1,46,0,5,2,710,598,112,482013332011,99500.0,29.669116723429184,-95.27453278042243,80,7,7,1,6
601,639,640,2135,795,2135,1645,490,486,61,393,3,21,0,8,4,1501,1128,373,370,54,294,3,16,0,3,3,795,725,70,482013332012,112000.0,29.67106575015773,-95.26849172628464,78,6,7,2,6
602,640,641,1001,289,1001,704,297,289,148,122,1,18,0,0,8,705,459,246,240,134,91,0,15,0,0,6,289,282,7,482013332013,127600.0,29.66772894174448,-95.26699513726186,74,6,7,2,6
603,641,642,945,326,945,665,280,275,158,99,1,11,2,4,5,646,421,225,222,137,73,1,7,2,2,3,326,296,30,482013332021,89800.0,29.659022433168047,-95.26068014415524,67,5,5,3,5
604,642,643,1275,520,1275,785,490,479,130,310,1,35,0,3,11,916,518,398,390,120,236,1,30,0,3,8,520,460,60,482013332022,101200.0,29.662172957343017,-95.2703466990984,78,5,6,1,6
605,643,644,1915,904,1915,1136,779,774,62,695,5,11,0,1,5,1340,748,592,589,56,519,5,8,0,1,3,904,775,129,482013332023,103400.0,29.66304332207377,-95.27500590887276,79,7,6,1,6
606,644,645,1539,814,1539,887,652,652,40,603,1,7,0,1,0,1088,600,488,488,34,446,1,7,0,0,0,814,641,173,482013332024,,29.659687194277197,-95.27455837219634,74,6,5,1,5
607,645,646,1511,484,1511,1205,306,293,180,79,3,30,1,0,13,994,751,243,234,149,57,2,25,1,0,9,484,443,41,482013333001,87900.0,29.645417036750104,-95.25538804084889,56,4,4,4,4
608,646,647,5858,2285,5858,3549,2309,2264,315,1864,1,82,0,2,45,3683,2223,1460,1441,265,1111,1,64,0,0,19,2285,2005,280,482013333002,111200.0,29.63153585207277,-95.24299985283317,52,4,3,6,5
609,647,648,2003,580,2003,1627,376,359,139,100,0,118,0,2,17,1360,1057,303,287,122,70,0,95,0,0,16,580,543,37,482013333003,92300.0,29.634805823274284,-95.2593470433734,51,4,4,4,4
610,648,649,1860,674,1860,1318,542,529,94,407,1,27,0,0,13,1233,842,391,382,86,271,1,24,0,0,9,674,596,78,482013335001,136000.0,29.668775033413432,-95.27927245892174,81,7,8,3,6
611,649,650,2453,851,2453,1844,609,591,219,341,3,25,0,3,18,1676,1176,500,485,201,256,3,23,0,2,15,851,721,130,482013335002,133300.0,29.66701712023967,-95.28479690597676,82,7,7,3,6
612,650,651,2120,904,2120,1449,671,654,88,537,3,23,2,1,17,1470,951,519,508,83,399,3,20,2,1,11,904,741,163,482013335003,133300.0,29.66035877740428,-95.28234859715955,75,6,7,3,6
613,651,652,1088,461,1088,656,432,422,303,100,5,14,0,0,10,829,457,372,368,269,85,1,13,0,0,4,461,389,72,482013336001,129400.0,29.664566435582667,-95.2935242037274,84,6,7,4,6
614,652,653,1024,349,1024,639,385,374,259,104,3,8,0,0,11,751,429,322,315,222,84,3,6,0,0,7,349,332,17,482013336002,140200.0,29.65716069357072,-95.29996870379944,71,5,6,3,5
615,653,654,1044,378,1044,607,437,431,314,95,3,13,0,6,6,759,405,354,352,263,71,2,11,0,5,2,378,351,27,482013336003,132000.0,29.653732355865746,-95.30859351256274,66,3,6,7,5
616,654,655,2094,607,2094,1608,486,476,194,174,6,101,0,1,10,1412,1027,385,378,165,130,3,79,0,1,7,607,579,28,482013337001,99300.0,29.63019388678809,-95.2764488057409,48,5,3,2,6
617,655,656,1062,366,1062,794,268,264,193,48,0,22,0,1,4,734,510,224,220,168,35,0,17,0,0,4,366,327,39,482013337002,87300.0,29.63689196113729,-95.29745009275756,44,4,4,1,3
618,656,657,1937,534,1937,1714,223,217,149,41,1,25,0,1,6,1211,1033,178,174,120,32,1,20,0,1,4,534,506,28,482013338001,57000.0,29.611742160023027,-95.29192768879145,40,3,3,1,4
619,657,658,2139,705,2139,1617,522,506,179,274,0,40,0,13,16,1443,1021,422,410,171,199,0,34,0,6,12,705,652,53,482013338002,111800.0,29.615694557422497,-95.28046597320052,39,4,3,1,5
620,658,659,1538,590,1538,807,731,713,150,541,1,17,1,3,18,1061,504,557,549,132,397,1,17,1,1,8,590,462,128,482013338003,104700.0,29.60602258852553,-95.27754653431292,37,4,3,1,4
621,659,660,1804,515,1804,1374,430,414,190,142,0,79,2,1,16,1266,926,340,328,156,112,0,57,2,1,12,515,493,22,482013338004,108800.0,29.62108451442395,-95.271352101407,38,4,3,2,6
622,660,661,1810,563,1810,1071,739,728,167,509,0,51,1,0,11,1282,699,583,577,142,390,0,44,1,0,6,563,546,17,482013338005,108800.0,29.611076939146745,-95.27112936807164,37,4,3,1,5
623,661,662,4858,1286,4858,2916,1942,1905,335,665,4,890,1,10,37,3126,1785,1341,1326,246,446,4,623,0,7,15,1286,1257,29,482013339011,134400.0,29.605600219974992,-95.25805659747196,39,4,3,3,3
624,662,663,3453,960,3453,2132,1321,1288,325,459,7,496,0,1,33,2189,1269,920,910,260,301,2,346,0,1,10,960,927,33,482013339012,125100.0,29.619189225634624,-95.25804334032642,40,4,3,3,4
625,663,664,3476,1219,3476,2173,1303,1275,510,575,6,178,3,3,28,2349,1357,992,975,444,391,6,129,3,2,17,1219,1153,66,482013339021,117600.0,29.620364956898968,-95.23454756418364,48,4,3,6,5
626,664,665,3025,912,3025,1879,1146,1115,556,308,3,240,2,6,31,2090,1202,888,869,457,217,3,189,2,1,19,912,887,25,482013339022,112800.0,29.61194131053917,-95.24624868037766,38,4,3,4,4
627,665,666,1716,923,1716,793,923,894,228,522,5,133,6,0,29,1313,570,743,720,198,406,3,109,4,0,23,923,803,120,482013339023,166300.0,29.62347793218345,-95.24320797946932,39,4,3,6,5
628,666,667,1409,547,1409,567,842,807,150,607,0,45,0,5,35,938,360,578,556,123,392,0,37,0,4,22,547,505,42,482013340011,110600.0,29.61707941548042,-95.22259828349098,66,5,4,6,4
629,667,668,1769,609,1769,872,897,873,397,342,3,128,0,3,24,1216,545,671,652,344,203,3,100,0,2,19,609,576,33,482013340012,106900.0,29.6142760949617,-95.22928640914668,64,5,4,6,4
630,668,669,636,364,636,217,419,406,244,120,1,38,2,1,13,523,161,362,352,228,92,1,29,1,1,10,364,321,43,482013340021,114300.0,29.61143848375783,-95.21715072000556,77,5,4,6,5
631,669,670,1453,807,1453,513,940,921,381,411,1,124,3,1,19,1158,386,772,763,340,317,1,103,1,1,9,807,717,90,482013340022,,29.60611909323276,-95.21218357492572,98,5,4,6,6
632,670,671,1876,658,1876,904,972,960,694,160,1,97,1,7,12,1437,616,821,815,603,121,1,84,1,5,6,658,632,26,482013340031,118500.0,29.60437012880986,-95.2219974086712,78,5,4,6,4
633,671,672,1186,579,1186,519,667,653,205,358,2,85,1,2,14,870,350,520,511,181,261,2,64,1,2,9,579,533,46,482013340032,1000001.0,29.60848231602405,-95.22572582813496,75,5,4,6,3
634,672,673,2866,1109,2866,1376,1490,1452,895,335,2,210,1,9,38,2072,887,1185,1169,767,236,1,159,1,5,16,1109,977,132,482013340033,113100.0,29.605739298978303,-95.23552699203653,46,5,3,6,3
635,673,674,1147,368,1147,369,778,772,24,741,1,6,0,0,6,837,227,610,607,22,578,1,6,0,0,3,368,351,17,482013341001,87400.0,29.63118494319442,-95.43916180575528,76,5,5,9,8
636,674,675,6286,3099,6286,1550,4736,4661,808,3195,13,635,3,7,75,4627,1048,3579,3517,728,2234,11,535,3,6,62,3099,2733,366,482013341002,137800.0,29.655147606327585,-95.41187053391958,139,8,15,22,12
637,675,676,1141,355,1141,464,677,670,38,624,3,3,0,2,7,871,306,565,558,37,515,3,3,0,0,7,355,339,16,482013341003,97000.0,29.632627207087157,-95.44400045537898,75,6,4,10,7
638,676,677,1340,493,1340,216,1124,1120,16,1085,9,9,0,1,4,1020,128,892,889,15,862,5,6,0,1,3,493,474,19,482013341004,104600.0,29.638261144243486,-95.44019322539994,99,8,6,18,9
639,677,678,3015,1154,3015,1273,1742,1697,990,429,4,267,1,6,45,2108,813,1295,1269,773,281,3,207,1,4,26,1154,1090,64,482013401001,133400.0,29.60192500187615,-95.18997170204295,122,6,5,6,6
640,678,679,1603,952,1603,431,1172,1138,546,425,3,162,1,1,34,1223,317,906,888,471,277,2,136,1,1,18,952,828,124,482013401002,,29.584419534484333,-95.17155540440744,137,5,5,5,6
641,679,680,397,362,397,50,347,334,215,6,0,113,0,0,13,288,30,258,249,167,5,0,77,0,0,9,362,144,218,482013402011,194400.0,29.61024521670901,-95.16091038032354,125,5,5,7,5
642,680,681,1256,502,1256,139,1117,1071,686,36,2,346,0,1,46,899,97,802,781,516,28,2,234,0,1,21,502,471,31,482013402012,168300.0,29.58742313113144,-95.14822361318008,133,5,4,6,6
643,681,682,2263,649,2263,158,2105,2062,1220,60,3,771,0,8,43,1473,100,1373,1351,811,34,1,503,0,2,22,649,646,3,482013402021,246800.0,29.61863174603953,-95.12794573777398,84,4,4,7,3
644,682,683,2314,752,2314,249,2065,2010,1400,79,10,517,0,4,55,1631,165,1466,1444,1004,55,8,376,0,1,22,752,735,17,482013402022,214800.0,29.599884292386367,-95.139397650818,135,5,6,7,6
645,683,684,0,0,0,0,0,0,0,0,0,0,0,0,0,0,0,0,0,0,0,0,0,0,0,0,0,0,0,482013402031,301200.0,29.60868367388665,-95.11197093229156,131,3,3,6,3
646,684,685,1688,593,1688,117,1571,1546,1215,49,0,281,0,1,25,1264,76,1188,1175,926,38,0,210,0,1,13,593,584,9,482013403011,459900.0,29.59539333273761,-95.13020888467976,138,4,4,7,5
647,685,686,2590,848,2590,205,2385,2335,1730,43,4,558,0,0,50,1860,126,1734,1710,1264,34,2,410,0,0,24,848,832,16,482013403012,392500.0,29.58851341881825,-95.12362345729328,125,3,3,7,5
648,686,687,2872,1064,2872,246,2626,2577,2320,71,10,172,0,4,49,2178,160,2018,1993,1787,53,5,145,0,3,25,1064,1044,20,482013403021,202000.0,29.589912930362583,-95.11066074145512,133,3,2,6,3
649,687,688,1930,649,1930,147,1783,1745,1359,41,4,325,1,15,38,1355,93,1262,1245,970,29,4,234,1,7,17,649,640,9,482013403022,314900.0,29.60378047749713,-95.11425171951366,133,3,3,6,3
650,688,689,2012,774,2012,264,1748,1718,1424,83,11,199,0,1,30,1533,168,1365,1355,1129,56,9,160,0,1,10,774,747,27,482013403023,139600.0,29.59904666455684,-95.11560348905964,138,3,3,6,3
651,689,690,1358,537,1358,95,1263,1235,1066,31,3,133,0,2,28,1092,68,1024,1008,877,26,2,103,0,0,16,537,530,7,482013404001,269800.0,29.57976192118951,-95.11254668358882,131,3,2,4,3
652,690,691,976,496,976,497,479,470,323,103,2,41,1,0,9,738,334,404,397,283,74,1,38,1,0,7,496,424,72,482013405001,93300.0,29.55972498416981,-95.1182898501793,124,3,4,2,5
653,691,692,1477,788,1477,625,852,831,581,149,3,90,7,1,21,1082,396,686,679,499,102,3,69,5,1,7,788,602,186,482013405002,81100.0,29.56174842765769,-95.12184128422696,122,3,4,3,6
654,692,693,2016,1096,2016,383,1633,1580,1196,140,2,239,0,3,53,1633,256,1377,1335,1020,114,2,196,0,3,42,1096,1000,96,482013405003,118300.0,29.569869012833607,-95.11571245303762,129,3,3,4,4
655,693,694,1110,426,1110,145,965,943,865,41,2,35,0,0,22,881,101,780,767,711,23,2,31,0,0,13,426,417,9,482013405004,141400.0,29.57107360988993,-95.12231997085438,124,3,4,5,6
656,694,695,788,300,788,118,670,658,595,33,1,28,1,0,12,622,87,535,526,478,26,1,20,1,0,9,300,293,7,482013405005,145700.0,29.56650085673153,-95.12725297017182,122,4,4,4,6
657,695,696,1501,606,1501,152,1349,1327,1207,32,3,84,0,1,22,1211,91,1120,1111,1007,27,3,73,0,1,9,606,594,12,482013406001,152900.0,29.57642803487694,-95.1288828894617,125,4,4,5,6
658,696,697,1010,382,1010,121,889,885,814,35,4,31,0,1,4,776,83,693,690,628,32,4,26,0,0,3,382,377,5,482013406002,150000.0,29.574967166440835,-95.13508554116856,127,5,5,5,6
659,697,698,1789,686,1789,297,1492,1455,1028,130,7,286,1,3,37,1308,192,1116,1097,784,100,5,206,1,1,19,686,650,36,482013407001,138500.0,29.567680415597437,-95.14126484967214,130,5,5,5,7
660,698,699,1840,713,1840,378,1462,1411,1188,115,17,78,1,12,51,1389,246,1143,1119,972,69,9,61,1,7,24,713,693,20,482013407002,128700.0,29.55803435543884,-95.13336573832022,124,4,5,3,6
661,699,700,2317,857,2317,554,1763,1729,913,120,10,675,8,3,34,1644,335,1309,1290,742,78,5,457,7,1,19,857,801,56,482013407003,122300.0,29.558953744438224,-95.12780031673192,123,4,4,3,6
662,700,701,1221,444,1221,204,1017,971,761,74,0,134,2,0,46,909,130,779,755,590,52,0,111,2,0,24,444,439,5,482013407004,147600.0,29.57179748511334,-95.13951805210152,131,5,5,5,7
663,701,702,1959,669,1959,217,1742,1705,1293,65,6,338,1,2,37,1483,155,1328,1307,963,58,5,280,1,0,21,669,657,12,482013408001,186000.0,29.57789669275915,-95.14901994113944,135,5,4,5,6
664,702,703,1602,589,1602,197,1405,1357,1099,52,3,194,0,9,48,1173,137,1036,1016,820,39,3,150,0,4,20,589,572,17,482013408002,160100.0,29.58239053033077,-95.13721359355252,131,5,4,5,6
665,703,704,2173,800,2173,300,1873,1824,1357,128,5,324,4,6,49,1578,181,1397,1374,1036,90,4,242,1,1,23,800,783,17,482013408003,161700.0,29.58625124445236,-95.14137270693035,132,5,4,5,6
666,704,705,1591,709,1591,452,1139,1092,713,228,3,143,1,4,47,1139,283,856,825,548,168,1,105,1,2,31,709,608,101,482013409001,117700.0,29.56282896372847,-95.14645113082004,129,5,5,3,7
667,705,706,2625,1455,2625,768,1857,1796,1116,359,8,300,5,8,61,2083,546,1537,1499,976,289,6,220,3,5,38,1455,1354,101,482013409002,112000.0,29.56687621406765,-95.15673035562396,130,5,5,4,7
668,706,707,1601,857,1601,345,1256,1211,923,172,6,108,0,2,45,1306,253,1053,1023,787,142,5,87,0,2,30,857,801,56,482013410001,94300.0,29.55552874102613,-95.14409860485756,129,5,5,3,7
669,707,708,1406,636,1406,326,1080,1055,816,161,2,71,0,5,25,1071,216,855,842,659,119,2,58,0,4,13,636,597,39,482013410002,115400.0,29.54945389944302,-95.14486566095054,128,5,5,3,7
670,708,709,2362,1278,2362,588,1774,1713,1132,374,4,196,2,5,61,1867,417,1450,1410,966,280,3,156,2,3,40,1278,1186,92,482013410003,109200.0,29.55707457542943,-95.1391620941826,128,5,5,3,7
671,709,710,390,150,390,85,305,297,230,38,1,25,0,3,8,276,52,224,217,175,21,1,19,0,1,7,150,149,1,482013410004,103400.0,29.551456886666973,-95.137607638934,128,5,5,3,7
672,710,711,0,0,0,0,0,0,0,0,0,0,0,0,0,0,0,0,0,0,0,0,0,0,0,0,0,0,0,482013411001,,29.552255483961915,-95.1215318851968,124,3,4,3,6
673,711,712,930,476,930,142,788,763,350,68,8,336,1,0,25,780,93,687,666,295,60,4,306,1,0,21,476,439,37,482013413011,304200.0,29.566871686622893,-95.09127852243624,146,3,4,3,5
674,712,713,1398,875,1398,104,1294,1281,1162,54,6,56,1,2,13,1270,77,1193,1184,1089,47,6,40,1,1,9,875,847,28,482013413012,134800.0,29.56199217156732,-95.10094299168192,147,3,3,2,5
675,713,714,1819,1111,1819,479,1340,1304,789,210,9,295,0,1,36,1508,337,1171,1146,713,171,9,252,0,1,25,1111,987,124,482013413013,66800.0,29.565740004065965,-95.11193241139526,128,3,3,3,4
676,714,715,941,529,941,276,665,647,419,125,1,102,0,0,18,757,195,562,548,356,98,1,93,0,0,14,529,478,51,482013413021,77500.0,29.550549295409294,-95.09890819989478,147,3,4,2,5
677,715,716,1471,831,1471,297,1174,1130,726,109,9,279,3,4,44,1187,210,977,942,637,82,5,214,2,2,35,831,745,86,482013413022,125700.0,29.554689387103828,-95.10996000467568,130,3,3,2,4
678,717,718,8,2,8,0,8,8,0,2,0,6,0,0,0,8,0,8,8,0,2,0,6,0,0,0,2,2,0,482013501001,198800.0,29.582714099217675,-95.21318888888985,95,3,3,4,7
679,719,720,765,228,765,447,318,306,188,65,9,44,0,0,12,520,274,246,240,152,46,8,34,0,0,6,228,215,13,482013502001,112300.0,29.59771962393357,-95.22225240281118,75,5,5,6,5
680,720,721,2010,631,2010,1028,982,971,707,191,3,59,1,10,11,1448,678,770,763,575,134,1,47,1,5,7,631,598,33,482013502003,117000.0,29.591266597772567,-95.2285337269116,66,4,3,6,4
681,721,722,0,0,0,0,0,0,0,0,0,0,0,0,0,0,0,0,0,0,0,0,0,0,0,0,0,0,0,482013502004,112200.0,29.600422371931625,-95.24091004042748,40,5,4,5,4
682,724,725,82,29,82,32,50,50,34,5,0,9,0,2,0,64,22,42,42,28,5,0,7,0,2,0,29,27,2,482013503004,130000.0,29.584759017480277,-95.2283112105268,67,4,3,4,4
683,725,726,923,292,923,456,467,459,374,70,1,12,0,2,8,641,282,359,356,294,50,1,9,0,2,3,292,281,11,482013504001,100500.0,29.60029816560974,-95.20642816079716,104,7,5,6,7
684,728,729,739,237,739,381,358,347,193,77,1,75,0,1,11,545,243,302,294,176,53,1,63,0,1,8,237,233,4,482013505001,93700.0,29.587052347368797,-95.20631536101112,105,6,3,5,7
685,729,730,1279,557,1279,688,591,565,182,246,8,128,1,0,26,883,430,453,438,146,187,3,101,1,0,15,557,467,90,482013505002,87600.0,29.59521329866074,-95.19692592240222,119,7,6,6,6
686,730,731,2842,956,2842,1163,1679,1635,798,333,2,495,3,4,44,1974,739,1235,1213,615,232,2,361,1,2,22,956,934,22,482013505003,108200.0,29.57907222642493,-95.19369495063836,112,5,4,4,6
687,731,732,1607,486,1607,1068,539,531,257,176,6,85,0,7,8,1122,684,438,434,216,132,4,75,0,7,4,486,465,21,482013505004,99300.0,29.59103628871227,-95.19826988785849,111,6,4,6,7
688,732,733,591,322,591,166,425,406,306,58,0,42,0,0,19,474,121,353,342,259,48,0,35,0,0,11,322,300,22,482013506011,118500.0,29.55777640907458,-95.16811615174076,130,5,6,3,7
689,734,735,2535,1520,2535,371,2164,2113,881,976,11,240,1,4,51,2061,299,1762,1727,862,624,11,225,1,4,35,1520,1405,115,482014101001,225900.0,29.75818623958644,-95.37985990635946,598,14,25,25,27
690,735,736,1258,606,1258,338,920,887,394,427,2,60,0,4,33,972,246,726,705,378,266,2,57,0,2,21,606,567,39,482014101002,211700.0,29.754654795921407,-95.38135107442491,586,14,24,25,27
691,736,737,1551,1065,1551,218,1333,1295,1175,44,3,72,1,0,38,1470,197,1273,1243,1132,41,3,66,1,0,30,1065,961,104,482014102001,413000.0,29.759794712013736,-95.38923024878471,623,15,25,26,31
692,737,738,959,626,959,187,772,756,683,23,1,44,0,5,16,882,158,724,713,644,20,1,43,0,5,11,626,554,72,482014102002,307600.0,29.7575416735129,-95.39517494054336,635,15,24,28,32
693,738,739,1692,1187,1692,369,1323,1292,1084,69,9,129,1,0,31,1588,312,1276,1252,1057,66,8,120,1,0,24,1187,1044,143,482014102003,284000.0,29.75507664484361,-95.3889391405265,609,15,25,25,30
694,739,740,156,18,156,8,148,148,125,20,0,3,0,0,0,155,7,148,148,125,20,0,3,0,0,0,18,18,0,482014103001,,29.75938876054816,-95.40464616571744,663,12,24,26,34
695,740,741,786,479,786,94,692,685,611,16,3,55,0,0,7,710,84,626,620,556,12,3,49,0,0,6,479,445,34,482014103002,211400.0,29.75458555705863,-95.40619537085122,650,12,23,26,33
696,741,742,1679,1211,1679,277,1402,1369,1118,110,1,129,0,11,33,1539,229,1310,1285,1066,92,1,116,0,10,25,1211,1050,161,482014103003,406700.0,29.75700723922049,-95.40014363662962,638,12,24,26,33
697,742,743,1810,1116,1810,304,1506,1489,1347,31,2,100,2,7,17,1621,236,1385,1373,1251,30,2,84,2,4,12,1116,1046,70,482014104011,316900.0,29.75025319622547,-95.40640341102473,658,13,23,26,34
698,743,744,1005,629,1005,200,805,780,708,30,1,38,0,3,25,891,159,732,714,645,27,1,38,0,3,18,629,558,71,482014104012,423800.0,29.745420375891204,-95.4085034587775,650,14,23,26,31
699,744,745,992,652,992,168,824,806,726,28,3,44,0,5,18,908,147,761,745,671,25,3,42,0,4,16,652,589,63,482014104013,370500.0,29.745482826882498,-95.40421086530404,643,14,23,26,30
700,745,746,1006,653,1006,255,751,733,623,34,0,73,0,3,18,888,191,697,689,586,33,0,69,0,1,8,653,585,68,482014104021,222000.0,29.749828539811592,-95.39858827749872,629,16,23,28,32
701,746,747,1550,918,1550,418,1132,1100,959,52,2,81,0,6,32,1361,321,1040,1022,890,46,2,79,0,5,18,918,833,85,482014104022,293900.0,29.7457328723932,-95.39882754884827,620,17,23,28,29
702,747,748,1582,1182,1582,304,1278,1248,1087,46,1,110,0,4,30,1487,263,1224,1201,1056,43,1,97,0,4,23,1182,998,184,482014105001,236700.0,29.74913592756892,-95.38334554184507,595,16,24,25,27
703,748,749,1025,694,1025,192,833,817,725,39,3,48,0,2,16,967,174,793,781,695,36,3,45,0,2,12,694,613,81,482014105002,244600.0,29.74906586610459,-95.38732251901958,609,16,24,25,29
704,749,750,590,399,590,101,489,478,417,16,4,39,0,2,11,554,93,461,453,394,16,4,37,0,2,8,399,348,51,482014105003,168100.0,29.74876194663645,-95.3904687366786,612,16,24,28,30
705,750,751,1012,645,1012,143,869,849,767,24,0,57,0,1,20,932,126,806,797,721,24,0,51,0,1,9,645,579,66,482014105004,284400.0,29.749411092213062,-95.39402741524177,621,16,23,28,32
706,751,752,1262,1171,1262,190,1072,1046,872,73,2,94,1,4,26,1189,134,1055,1030,865,66,2,93,1,3,25,1171,851,320,482014106001,1000001.0,29.7445388736998,-95.37776948442864,570,16,24,25,24
707,752,753,1944,1529,1944,245,1699,1661,1433,111,8,98,2,9,38,1902,232,1670,1634,1414,106,8,95,2,9,36,1529,1355,174,482014106002,266300.0,29.749385637952987,-95.37789582376574,580,15,24,25,26
708,753,754,844,576,844,126,718,709,595,85,0,26,0,3,9,801,114,687,678,567,83,0,25,0,3,9,576,508,68,482014107011,120400.0,29.74167825814242,-95.39181726912383,588,17,23,28,27
709,754,755,852,593,852,109,743,730,671,15,3,38,2,1,13,796,99,697,687,631,15,3,35,2,1,10,593,532,61,482014107012,264500.0,29.740912913780363,-95.39696788312808,602,16,23,28,28
710,755,756,1122,868,1122,195,927,907,786,82,2,33,0,4,20,1063,172,891,875,759,77,2,33,0,4,16,868,778,90,482014107013,333000.0,29.740353190806847,-95.38603324652452,575,17,25,25,26
711,756,757,822,580,822,142,680,668,595,38,1,32,1,1,12,753,121,632,622,553,36,0,31,1,1,10,580,478,102,482014107014,346900.0,29.74346158775288,-95.38504526843614,578,17,24,25,26
712,757,758,1163,1019,1163,154,1009,993,793,142,3,54,0,1,16,1110,130,980,965,770,141,3,50,0,1,15,1019,830,189,482014107021,328700.0,29.73629334822612,-95.38599801127252,565,17,25,22,26
713,758,759,1459,763,1459,400,1059,1025,770,50,1,197,2,5,34,1350,335,1015,984,737,50,1,190,2,4,31,763,676,87,482014107022,212100.0,29.73659698608156,-95.3952273336681,588,16,23,27,28
714,759,760,1036,705,1036,152,884,866,797,19,0,47,1,2,18,922,133,789,778,720,19,0,38,1,0,11,705,614,91,482014108001,367800.0,29.740708566522898,-95.40319000691632,624,13,23,26,30
715,760,761,1696,1188,1696,519,1177,1144,993,61,3,83,2,2,33,1506,392,1114,1088,944,57,3,80,2,2,26,1188,1049,139,482014108002,365500.0,29.738298034338687,-95.4086431694098,629,13,23,26,30
716,761,762,1086,682,1086,313,773,745,666,29,1,48,1,0,28,934,247,687,665,596,26,1,41,1,0,22,682,604,78,482014108003,322900.0,29.736497660918957,-95.40279309205084,607,13,23,26,29
717,762,763,1132,827,1132,208,924,896,775,59,0,58,1,3,28,1032,170,862,838,725,54,0,55,1,3,24,827,726,101,482014109001,411300.0,29.73316132659253,-95.39335962832652,572,16,23,25,27
718,763,764,826,531,826,160,666,660,581,36,0,41,0,2,6,744,132,612,608,538,31,0,37,0,2,4,531,489,42,482014109002,357900.0,29.732799775916813,-95.40198955724374,597,13,23,24,29
719,764,765,726,451,726,146,580,571,489,32,3,47,0,0,9,645,119,526,523,454,28,1,40,0,0,3,451,400,51,482014109003,441700.0,29.732648258979868,-95.40756041312402,609,13,23,24,30
720,765,766,1405,1197,1405,155,1250,1240,1109,45,2,84,0,0,10,1313,138,1175,1166,1043,40,2,81,0,0,9,1197,937,260,482014110001,221800.0,29.740284915884363,-95.42437391056968,658,13,22,27,34
721,766,767,1398,1188,1398,152,1246,1222,1038,45,3,132,2,2,24,1326,144,1182,1162,1000,38,3,118,2,1,20,1188,927,261,482014110002,422700.0,29.740505988608295,-95.41470389740002,640,14,23,27,32
722,767,768,1359,960,1359,155,1204,1184,1012,45,3,122,0,2,20,1244,138,1106,1089,929,42,3,113,0,2,17,960,853,107,482014110003,381500.0,29.734698516157103,-95.41469777295796,628,14,23,25,32
723,768,769,1402,591,1402,53,1349,1335,1262,22,1,45,0,5,14,1025,42,983,978,922,19,1,35,0,1,5,591,519,72,482014111001,1000001.0,29.75370684236383,-95.41364493398294,659,12,23,27,34
724,769,770,926,634,926,119,807,796,702,33,3,58,0,0,11,820,90,730,728,655,26,3,44,0,0,2,634,558,76,482014111002,778400.0,29.74780599711466,-95.41470158126944,667,13,23,27,34
725,770,771,1122,550,1122,171,951,943,790,46,1,103,0,3,8,887,123,764,760,655,32,1,71,0,1,4,550,521,29,482014111003,846500.0,29.744609302273737,-95.41471530152972,655,14,23,27,33
726,771,772,1086,495,1086,73,1013,1004,934,13,2,53,0,2,9,854,61,793,789,733,10,2,42,0,2,4,495,452,43,482014112001,1000001.0,29.754021179667507,-95.43258476949212,673,11,22,27,37
727,772,773,717,275,717,26,691,685,663,1,0,21,0,0,6,559,20,539,533,517,1,0,15,0,0,6,275,263,12,482014112002,1000001.0,29.75053288310821,-95.42734563281157,681,12,21,27,38
728,773,774,1497,1086,1497,162,1335,1327,1156,50,5,113,1,2,8,1399,143,1256,1250,1098,38,5,107,1,1,6,1086,915,171,482014113001,400500.0,29.752189766468558,-95.45236816675258,636,9,20,25,34
729,774,775,1198,1043,1198,249,949,932,697,125,0,108,1,1,17,1125,219,906,890,685,106,0,97,1,1,16,1043,865,178,482014113002,322200.0,29.744166849987547,-95.45517392398396,619,10,18,25,33
730,775,776,688,560,688,147,541,525,377,66,3,77,1,1,16,654,138,516,503,362,63,3,73,1,1,13,560,488,72,482014113003,570300.0,29.74374653966101,-95.45066764258831,616,11,20,26,33
731,776,777,1372,762,1372,55,1317,1314,1261,22,0,30,0,1,3,1125,41,1084,1083,1045,16,0,21,0,1,1,762,679,83,482014114001,671200.0,29.74426483357244,-95.44202675204856,651,12,23,28,36
732,777,778,772,292,772,38,734,729,702,6,0,21,0,0,5,576,31,545,544,527,4,0,13,0,0,1,292,277,15,482014114002,930600.0,29.74476274971998,-95.43131603237468,670,13,22,27,35
733,778,779,631,263,631,15,616,614,588,6,1,19,0,0,2,482,12,470,469,449,3,1,16,0,0,1,263,244,19,482014114003,1000001.0,29.745056195767763,-95.4226119177366,677,13,22,27,35
734,779,780,2105,1591,2105,337,1768,1731,1342,152,3,227,3,4,37,1969,300,1669,1640,1277,137,3,217,2,4,29,1591,1391,200,482014115011,225000.0,29.73199249710309,-95.44092379420792,621,13,23,26,34
735,780,781,1748,1671,1748,219,1529,1507,1271,75,2,157,2,0,22,1539,184,1355,1335,1122,63,2,146,2,0,20,1671,1024,647,482014115012,407600.0,29.73540357432342,-95.44329875739028,628,11,21,26,34
736,781,782,1380,937,1380,164,1216,1189,1022,44,0,120,0,3,27,1273,145,1128,1105,948,43,0,112,0,2,23,937,857,80,482014115013,428800.0,29.739946003597776,-95.44243505992613,640,11,22,28,34
737,782,783,1284,874,1284,146,1138,1117,911,58,3,144,0,1,21,1147,124,1023,1008,834,45,3,125,0,1,15,874,789,85,482014115021,692300.0,29.73623530905358,-95.42425012549994,648,13,22,25,34
738,783,784,706,585,706,80,626,619,528,28,0,62,0,1,7,670,72,598,591,506,25,0,59,0,1,7,585,496,89,482014115022,170200.0,29.73787568619234,-95.43239260324783,649,13,22,27,34
739,784,785,722,567,722,127,595,580,455,37,3,76,2,7,15,677,113,564,550,432,36,3,70,2,7,14,567,512,55,482014115023,281800.0,29.73283055914973,-95.43358890950444,633,13,22,25,34
740,785,786,1204,865,1204,166,1038,1022,805,70,1,146,0,0,16,1135,156,979,965,764,63,1,137,0,0,14,865,794,71,482014115024,223200.0,29.732313554424035,-95.42382535718596,639,13,22,25,34
741,786,787,1256,641,1256,90,1166,1150,1090,13,6,40,1,0,16,1068,76,992,985,935,11,6,32,1,0,7,641,597,44,482014116001,555000.0,29.7362492621572,-95.4508574320251,599,11,20,24,32
742,787,788,1051,639,1051,91,960,941,859,44,0,38,0,0,19,861,80,781,768,696,40,0,32,0,0,13,639,532,107,482014116002,432600.0,29.73477674255695,-95.45637467052003,594,10,18,23,31
743,788,789,770,616,770,164,606,598,446,68,2,82,0,0,8,714,140,574,566,425,63,2,76,0,0,8,616,529,87,482014117001,75500.0,29.728450613962305,-95.45419756746394,541,12,19,22,26
744,789,790,2004,1433,2004,304,1700,1662,1189,177,3,291,1,1,38,1887,275,1612,1578,1140,170,3,263,1,1,34,1433,1364,69,482014117002,,29.723851230119298,-95.45445367544936,533,12,19,22,28
745,790,791,1068,933,1068,136,932,916,748,38,2,125,0,3,16,1011,121,890,876,735,34,2,102,0,3,14,933,813,120,482014118001,,29.72819064016946,-95.42289866715822,588,13,23,24,30
746,791,792,1282,769,1282,138,1144,1119,833,42,2,239,0,3,25,1039,104,935,917,689,35,2,189,0,2,18,769,694,75,482014118002,426800.0,29.72640823879248,-95.43288353949606,580,13,23,24,30
747,792,793,1496,905,1496,177,1319,1288,1065,40,2,179,2,0,31,1240,141,1099,1083,912,33,2,136,0,0,16,905,813,92,482014118003,309900.0,29.72645020888035,-95.4409530401606,571,13,24,25,30
748,793,794,989,589,989,88,901,881,708,33,5,126,0,9,20,832,69,763,751,611,28,3,103,0,6,12,589,532,57,482014118004,468800.0,29.728196883789717,-95.4145758188756,569,14,24,24,28
749,794,795,699,435,699,107,592,588,555,11,3,19,0,0,4,589,62,527,523,494,11,3,15,0,0,4,435,371,64,482014119001,584200.0,29.729923152310555,-95.39533274840495,543,16,23,24,27
750,795,796,1384,725,1384,121,1263,1246,1181,13,2,44,0,6,17,1121,91,1030,1021,970,10,2,36,0,3,9,725,655,70,482014119002,538000.0,29.72839363759191,-95.40497421827824,561,13,24,23,27
751,796,797,1598,1138,1598,134,1464,1422,1200,53,4,161,2,2,42,1471,118,1353,1320,1109,48,4,157,2,0,33,1138,1025,113,482014119003,396400.0,29.72660061623012,-95.39297582973424,525,16,24,24,25
752,797,798,1168,584,1168,79,1089,1063,952,28,0,82,0,1,26,946,51,895,876,786,17,0,73,0,0,19,584,528,56,482014120001,746000.0,29.72309588107612,-95.40435631537704,552,13,24,23,28
753,798,799,893,506,893,68,825,802,694,5,9,91,0,3,23,736,60,676,663,578,5,7,72,0,1,13,506,443,63,482014120002,472700.0,29.72030561528313,-95.4156217560932,566,14,23,25,30
754,799,800,831,359,831,32,799,792,745,11,0,34,0,2,7,639,19,620,618,583,7,0,26,0,2,2,359,335,24,482014120003,680000.0,29.72165106532731,-95.41056602637008,563,13,23,24,28
755,800,801,2328,4,2328,305,2023,1979,1006,110,0,858,4,1,44,2322,305,2017,1974,1005,109,0,855,4,1,43,4,4,0,482014121001,,29.71723111903158,-95.40273935527206,538,13,23,24,28
756,801,802,696,284,696,33,663,654,605,13,0,36,0,0,9,516,29,487,483,451,9,0,23,0,0,4,284,265,19,482014122001,806100.0,29.70180408765913,-95.4108901387577,509,12,22,24,28
757,802,803,991,454,991,40,951,930,860,19,1,46,0,4,21,749,32,717,705,649,17,1,37,0,1,12,454,409,45,482014122002,558500.0,29.711899178878262,-95.4077598747546,540,13,23,24,28
758,803,804,1495,833,1495,175,1320,1280,902,62,0,314,0,2,40,1214,131,1083,1065,772,49,0,243,0,1,18,833,728,105,482014122003,554800.0,29.707187730755624,-95.40864625636875,521,12,22,24,28
759,804,805,2173,944,2173,201,1972,1921,1553,36,4,319,0,9,51,1727,159,1568,1540,1236,32,4,263,0,5,28,944,869,75,482014122004,465300.0,29.709760887566183,-95.41548447341908,537,13,23,25,30
760,805,806,7,2,7,0,7,5,4,0,0,1,0,0,2,4,0,4,4,3,0,0,1,0,0,0,2,2,0,482014126001,703900.0,29.70906651040618,-95.44720884831324,503,10,20,24,29
761,806,807,11,3,11,0,11,7,7,0,0,0,0,0,4,8,0,8,4,4,0,0,0,0,0,4,3,3,0,482014126002,596700.0,29.721322036384624,-95.44752997384266,537,11,20,24,29
762,807,808,0,0,0,0,0,0,0,0,0,0,0,0,0,0,0,0,0,0,0,0,0,0,0,0,0,0,0,482014126003,643800.0,29.71519064072189,-95.4473778496834,528,11,20,24,29
763,808,809,0,0,0,0,0,0,0,0,0,0,0,0,0,0,0,0,0,0,0,0,0,0,0,0,0,0,0,482014127001,329800.0,29.720065819290085,-95.44802886466732,538,11,20,24,30
764,809,810,12,6,12,0,12,9,9,0,0,0,0,0,3,8,0,8,6,6,0,0,0,0,0,2,6,4,2,482014127002,532700.0,29.71276380163983,-95.44788108552048,517,11,20,24,29
765,810,811,19,7,19,6,13,13,12,1,0,0,0,0,0,11,4,7,7,6,1,0,0,0,0,0,7,6,1,482014128001,567400.0,29.702419910474656,-95.44748336591952,484,10,19,24,29
766,811,812,28,9,28,2,26,26,20,0,0,6,0,0,0,17,1,16,16,11,0,0,5,0,0,0,9,9,0,482014128002,582400.0,29.696778477219567,-95.44738185051152,443,10,19,24,29
767,812,813,6,4,6,0,6,6,6,0,0,0,0,0,0,5,0,5,5,5,0,0,0,0,0,0,4,4,0,482014128003,465700.0,29.692153802602515,-95.44728283332852,433,11,19,24,29
768,813,814,1269,912,1269,187,1082,1033,582,248,4,193,3,3,49,1113,155,958,922,534,214,4,164,3,3,36,912,770,142,482014129001,,29.68630082116896,-95.45422008371229,412,12,17,23,24
769,814,815,1700,982,1700,218,1482,1446,895,197,3,346,0,5,36,1397,168,1229,1205,745,166,3,287,0,4,24,982,841,141,482014129002,274300.0,29.68418303665463,-95.44761370587848,407,12,17,24,25
770,815,816,923,444,923,89,834,818,491,128,0,196,1,2,16,781,62,719,713,443,107,0,160,1,2,6,444,423,21,482014129003,221600.0,29.682399024530163,-95.44313287772349,401,12,18,26,26
771,816,817,1813,693,1813,216,1597,1561,1267,86,1,200,4,3,36,1252,135,1117,1109,909,56,1,138,4,1,8,693,648,45,482014130001,399100.0,29.69674559234117,-95.44410970296384,461,10,19,25,31
772,817,818,1647,1023,1647,327,1320,1292,974,79,12,220,1,6,28,1318,240,1078,1063,795,68,10,183,1,6,15,1023,806,217,482014130002,460200.0,29.69846871594487,-95.4390279066458,501,11,21,26,31
773,818,819,1160,497,1160,106,1054,1029,859,30,0,135,0,5,25,868,70,798,782,653,25,0,102,0,2,16,497,450,47,482014131001,458800.0,29.70073879255736,-95.42961728451382,516,12,20,25,31
774,819,820,945,335,945,91,854,832,776,9,3,44,0,0,22,634,49,585,577,532,9,3,33,0,0,8,335,317,18,482014131002,436000.0,29.69649547872155,-95.43260181078448,481,11,20,25,31
775,820,821,982,350,982,87,895,852,754,32,1,64,0,1,43,642,43,599,581,511,23,1,45,0,1,18,350,329,21,482014131003,467700.0,29.698469354935945,-95.43555711768734,503,11,20,25,31
776,821,822,1110,829,1110,157,953,938,579,94,2,262,0,1,15,997,130,867,852,533,87,2,229,0,1,15,829,695,134,482014132011,366700.0,29.698396417398385,-95.42426946435356,511,11,21,25,31
777,822,823,1516,1043,1516,203,1313,1273,929,67,1,271,0,5,40,1381,174,1207,1173,871,62,1,238,0,1,34,1043,857,186,482014132012,,29.703484371410443,-95.42525188996484,533,12,21,25,31
778,823,824,924,723,924,149,775,749,546,29,1,171,0,2,26,849,137,712,694,522,28,1,141,0,2,18,723,606,117,482014132021,158100.0,29.69905932483106,-95.41712721688316,506,12,22,25,30
779,824,825,1954,1458,1954,305,1649,1610,1040,159,4,401,1,5,39,1775,268,1507,1471,992,136,4,333,1,5,36,1458,1223,235,482014132022,104200.0,29.7017243722432,-95.4207685535398,530,12,22,25,31
780,825,826,1716,1066,1716,232,1484,1443,782,279,3,377,1,1,41,1485,200,1285,1254,700,233,3,317,1,0,31,1066,950,116,482014133001,190900.0,29.69325853666948,-95.41907053848097,480,11,22,25,31
781,826,827,1917,1052,1917,240,1677,1644,899,488,3,247,0,7,33,1549,184,1365,1341,745,399,3,189,0,5,24,1052,924,128,482014133002,296800.0,29.68838415188557,-95.42480169616508,460,12,21,25,29
782,827,828,1287,586,1287,187,1100,1084,829,65,4,180,6,0,16,1018,140,878,871,672,42,4,149,4,0,7,586,548,38,482014133003,260300.0,29.68592961072848,-95.4296389840551,439,13,18,25,28
783,828,829,1048,487,1048,150,898,872,646,65,0,161,0,0,26,774,96,678,668,488,58,0,122,0,0,10,487,442,45,482014133004,328500.0,29.68783002265518,-95.43538439290133,440,12,20,25,29
784,829,830,929,404,929,92,837,818,634,45,4,134,0,1,19,716,61,655,641,500,35,4,101,0,1,14,404,379,25,482014133005,267600.0,29.682151871283285,-95.43571763027524,408,13,18,25,26
785,830,831,1895,882,1895,870,1025,1002,329,369,3,291,4,6,23,1432,571,861,847,285,314,3,239,4,2,14,882,801,81,482014201001,207700.0,29.67581861113752,-95.4349516683246,348,12,16,25,24
786,831,832,1167,659,1167,381,786,771,65,671,2,33,0,0,15,907,272,635,625,60,532,2,31,0,0,10,659,587,72,482014201002,,29.668977329210268,-95.43715513014035,265,11,15,25,20
787,832,833,1372,579,1372,505,867,833,550,117,3,157,1,5,34,1098,365,733,709,478,94,2,131,1,3,24,579,537,42,482014202001,127500.0,29.66484341886848,-95.44351134139475,223,10,15,25,19
788,833,834,1175,397,1175,686,489,453,232,102,1,114,0,4,36,847,445,402,381,204,77,1,97,0,2,21,397,381,16,482014202002,190900.0,29.676328349483253,-95.44333715160292,350,11,17,26,24
789,834,835,1503,869,1503,219,1284,1252,649,517,2,79,1,4,32,1259,173,1086,1064,536,450,2,73,1,2,22,869,800,69,482014203001,285700.0,29.67600904238441,-95.45401343341751,354,12,17,23,22
790,835,836,839,365,839,90,749,728,658,27,2,41,0,0,21,667,58,609,597,543,24,2,28,0,0,12,365,352,13,482014203002,259700.0,29.66840447739053,-95.45880580608512,271,11,17,23,21
791,836,837,1069,453,1069,139,930,917,846,28,1,37,1,4,13,840,97,743,736,680,22,1,28,1,4,7,453,441,12,482014203003,268800.0,29.668460608269527,-95.45105403101203,268,10,16,23,20
792,837,838,1084,508,1084,132,952,937,793,52,2,90,0,0,15,893,110,783,772,664,39,2,67,0,0,11,508,487,21,482014204001,169400.0,29.660644530014,-95.46019528190833,186,10,15,22,16
793,838,839,1453,698,1453,163,1290,1265,1111,63,2,88,0,1,25,1168,107,1061,1043,925,45,2,70,0,1,18,698,660,38,482014204002,175500.0,29.659988598280886,-95.45256584881083,183,9,14,23,16
794,839,840,856,396,856,322,534,519,381,60,0,77,0,1,15,682,220,462,456,334,52,0,69,0,1,6,396,367,29,482014204003,114100.0,29.654686974983733,-95.45589264336532,152,10,14,23,14
795,840,841,894,304,894,714,180,177,49,112,0,12,0,4,3,620,484,136,133,42,79,0,11,0,1,3,304,280,24,482014205001,87700.0,29.644812784613517,-95.47784481763986,137,9,10,17,9
796,841,842,1848,571,1848,1388,460,456,60,384,2,10,0,0,4,1192,827,365,365,53,302,2,8,0,0,0,571,533,38,482014205002,,29.654185986339247,-95.47019617160372,163,11,13,20,14
797,842,843,1299,564,1299,854,445,438,21,152,0,264,0,1,7,909,543,366,361,16,119,0,226,0,0,5,564,438,126,482014205003,,29.64888684032065,-95.47234171180988,148,9,13,20,11
798,843,844,598,349,598,139,459,441,343,67,1,29,0,1,18,495,99,396,388,308,53,1,25,0,1,8,349,305,44,482014206001,74200.0,29.65585354884594,-95.47597917987028,171,11,13,19,12
799,844,845,1634,670,1634,516,1118,1095,869,151,0,74,0,1,23,1226,322,904,889,727,98,0,63,0,1,15,670,635,35,482014206002,189000.0,29.66285070429497,-95.46819883744422,221,11,15,21,17
800,845,846,903,342,903,73,830,811,704,19,0,82,0,6,19,675,51,624,615,540,10,0,61,0,4,9,342,326,16,482014207001,354500.0,29.676020294747072,-95.46314745636668,345,11,18,22,21
801,846,847,590,248,590,46,544,543,493,13,0,37,0,0,1,482,30,452,452,419,7,0,26,0,0,0,248,244,4,482014207002,376300.0,29.675752058821384,-95.47207819890193,348,11,16,19,20
802,847,848,1646,659,1646,156,1490,1470,1270,47,0,145,0,8,20,1248,109,1139,1131,978,34,0,114,0,5,8,659,634,25,482014207003,269400.0,29.66835435572939,-95.47189203919756,279,11,15,19,18
803,848,849,803,321,803,74,729,715,588,28,3,96,0,0,14,630,58,572,568,464,20,3,81,0,0,4,321,304,17,482014208001,330300.0,29.684814881139573,-95.46352669211352,391,11,18,22,24
804,849,850,853,341,853,72,781,768,620,2,0,145,0,1,13,677,50,627,622,512,2,0,107,0,1,5,341,331,10,482014208002,398700.0,29.68351490811877,-95.47039460515602,390,11,15,20,24
805,850,851,856,338,856,48,808,798,646,5,5,142,0,0,10,672,33,639,635,520,3,3,109,0,0,4,338,330,8,482014208003,325800.0,29.684440566729343,-95.4747809688068,381,11,14,19,23
806,851,852,758,504,758,159,599,589,382,94,1,112,0,0,10,688,144,544,535,350,89,1,95,0,0,9,504,472,32,482014211011,115800.0,29.723042475994152,-95.46850593484348,509,10,19,21,27
807,852,853,2971,1231,2971,2117,854,830,213,436,2,179,0,0,24,2068,1370,698,677,178,344,2,153,0,0,21,1231,1162,69,482014211012,,29.720135270969607,-95.47455133028184,484,10,16,20,27
808,853,854,2674,1205,2674,2392,282,272,83,170,3,11,0,5,10,1798,1573,225,218,57,143,3,11,0,4,7,1205,915,290,482014211021,,29.721776305283733,-95.48124905640908,481,13,13,15,28
809,854,855,1345,736,1345,341,1004,982,113,496,3,362,0,8,22,1129,265,864,848,104,396,1,341,0,6,16,736,603,133,482014211022,,29.71829530682263,-95.48064227649157,484,13,13,15,28
810,855,856,1525,360,1525,1460,65,65,26,25,0,11,0,3,0,913,866,47,47,19,17,0,11,0,0,0,360,319,41,482014211023,,29.724363593020847,-95.47975039212096,492,13,15,16,28
811,856,857,2078,964,2078,1633,445,430,110,246,1,65,0,8,15,1581,1186,395,384,104,214,0,62,0,4,11,964,887,77,482014212011,,29.723986739577008,-95.4870546719661,456,11,9,9,27
812,857,858,1777,740,1777,1329,448,445,54,307,0,83,0,1,3,1186,848,338,335,50,222,0,62,0,1,3,740,614,126,482014212012,,29.721770573144227,-95.49096100148404,447,10,10,8,26
813,858,859,544,187,544,537,7,7,6,1,0,0,0,0,0,370,368,2,2,1,1,0,0,0,0,0,187,161,26,482014212013,,29.72097761143761,-95.48690019179227,453,12,9,10,27
814,859,860,1665,694,1665,1389,276,264,41,179,0,44,0,0,12,1051,874,177,170,33,108,0,29,0,0,7,694,514,180,482014212021,,29.7183834150411,-95.4902831261186,449,10,10,8,27
815,860,861,2005,761,2005,1929,76,75,26,36,1,7,0,5,1,1405,1351,54,53,19,26,1,5,0,2,1,761,605,156,482014212022,,29.71822144921657,-95.48690821872734,454,12,9,10,27
816,861,862,475,228,475,394,81,76,11,58,0,7,0,0,5,334,273,61,56,11,38,0,7,0,0,5,228,174,54,482014212023,,29.718015445029632,-95.49479247539024,409,10,10,7,26
817,862,863,2282,864,2282,538,1744,1628,403,321,3,896,0,5,116,1570,356,1214,1139,280,246,0,609,0,4,75,864,781,83,482014213001,62000.0,29.709465241129777,-95.5035923247607,319,9,11,8,22
818,863,864,2631,1171,2631,2283,348,333,110,198,0,24,0,1,15,1910,1609,301,289,93,173,0,22,0,1,12,1171,984,187,482014213002,,29.708718626368302,-95.49501854194172,382,9,10,7,24
819,864,865,1722,530,1722,931,791,759,204,211,5,335,0,4,32,1131,577,554,536,153,146,4,230,0,3,18,530,490,40,482014213003,56900.0,29.708168309877703,-95.49881067866625,361,9,9,8,23
820,865,866,1390,605,1390,1256,134,131,35,77,1,16,0,2,3,882,788,94,92,29,50,0,12,0,1,2,605,418,187,482014214011,,29.71405849184101,-95.4907110503621,446,10,10,8,25
821,866,867,2236,769,2236,1864,372,362,43,113,2,198,0,6,10,1576,1297,279,273,32,69,2,168,0,2,6,769,675,94,482014214012,,29.714682354289053,-95.4936036632092,418,10,10,7,26
822,867,868,1879,656,1879,1798,81,79,32,39,0,6,0,2,2,1216,1164,52,52,15,33,0,4,0,0,0,656,524,132,482014214021,,29.71554986161429,-95.4868795625748,449,12,9,10,27
823,868,869,1561,726,1561,1495,66,64,20,41,0,2,0,1,2,1005,949,56,55,17,35,0,2,0,1,1,726,493,233,482014214022,,29.713753137024582,-95.48684786942498,447,12,9,10,26
824,869,870,1411,476,1411,1367,44,44,19,17,0,5,0,3,0,984,950,34,34,12,16,0,5,0,1,0,476,414,62,482014214031,,29.707013791042904,-95.48957313806235,405,9,9,8,25
825,870,871,2153,612,2153,1682,471,451,83,200,0,166,0,2,20,1455,1129,326,309,59,116,0,133,0,1,17,612,570,42,482014214032,48500.0,29.71091009643312,-95.49100438242849,427,10,10,8,25
826,871,872,799,251,799,636,163,162,114,26,0,22,0,0,1,588,441,147,146,108,20,0,18,0,0,1,251,242,9,482014214033,132300.0,29.71006054481455,-95.48678949396616,421,11,9,10,26
827,872,873,1090,425,1090,590,500,490,134,272,3,78,0,3,10,734,380,354,347,97,175,3,70,0,2,7,425,370,55,482014215001,,29.7124247025904,-95.47994406351113,472,13,14,16,27
828,873,874,2264,832,2264,1867,397,385,158,162,2,61,0,2,12,1573,1256,317,308,132,117,2,55,0,2,9,832,729,103,482014215002,,29.70740178584005,-95.48048706300162,437,12,12,15,26
829,874,875,1345,597,1345,832,513,493,305,93,3,90,0,2,20,1006,547,459,444,277,86,3,76,0,2,15,597,532,65,482014215003,322500.0,29.7129028818776,-95.47311628969864,479,10,16,20,25
830,875,876,1785,927,1785,483,1302,1275,239,705,1,324,0,6,27,1461,362,1099,1077,217,552,1,302,0,5,22,927,795,132,482014215004,,29.714630549839985,-95.4831768463218,459,13,12,12,28
831,876,877,1778,561,1778,1560,218,215,65,136,1,11,0,2,3,1134,972,162,159,54,94,1,9,0,1,3,561,480,81,482014216001,,29.700695816348137,-95.49096522420751,387,9,9,7,24
832,877,878,2158,653,2158,2030,128,119,40,36,0,38,0,5,9,1352,1253,99,94,36,28,0,26,0,4,5,653,574,79,482014216002,,29.70255686057144,-95.48384227427744,401,12,9,10,26
833,878,879,1453,628,1453,626,827,815,437,36,1,341,0,0,12,1047,425,622,616,343,30,1,242,0,0,6,628,569,59,482014216003,260900.0,29.701753813938755,-95.47744560186264,425,10,13,18,26
834,879,880,1625,513,1625,1488,137,135,34,78,3,7,0,13,2,1029,944,85,84,26,43,1,7,0,7,1,513,399,114,482014216004,,29.70154019982179,-95.48775058310896,393,9,9,9,25
835,880,881,1547,599,1547,1082,465,453,262,93,4,94,0,0,12,1104,720,384,373,223,69,4,77,0,0,11,599,556,43,482014217001,552600.0,29.69522069420672,-95.48721523585796,372,10,8,9,25
836,881,882,937,367,937,288,649,636,501,14,0,119,0,2,13,712,168,544,538,430,12,0,94,0,2,6,367,349,18,482014217002,234800.0,29.691275565019534,-95.48933505071328,370,10,9,7,25
837,882,883,1202,483,1202,113,1089,1081,843,15,0,220,0,3,8,941,75,866,862,683,9,0,167,0,3,4,483,469,14,482014217003,248700.0,29.68233756233885,-95.48939296683568,356,11,9,7,23
838,883,884,874,447,874,73,801,794,630,30,0,133,0,1,7,723,59,664,661,543,22,0,95,0,1,3,447,427,20,482014217004,194600.0,29.682397557209185,-95.485405170502,349,14,8,9,24
839,884,885,1422,859,1422,298,1124,1064,588,386,0,83,0,7,60,1152,223,929,892,517,305,0,66,0,4,37,859,754,105,482014218001,,29.677476375779836,-95.4816869583978,342,14,11,14,23
840,885,886,1220,736,1220,390,830,812,247,518,10,34,0,3,18,907,268,639,624,214,373,9,28,0,0,15,736,590,146,482014218002,,29.680410775076453,-95.47817451567494,360,12,13,17,23
841,886,887,1136,666,1136,190,946,923,548,237,1,136,0,1,23,915,143,772,756,467,182,1,105,0,1,16,666,578,88,482014218003,292800.0,29.68125745064546,-95.48178235789872,358,14,11,14,23
842,887,888,1227,528,1227,93,1134,1118,893,18,1,204,0,2,16,974,67,907,895,723,11,1,158,0,2,12,528,505,23,482014218004,255500.0,29.687335607027617,-95.48052265757028,378,13,12,14,24
843,888,889,998,409,998,107,891,880,809,25,2,42,0,2,11,756,67,689,684,626,22,2,32,0,2,5,409,394,15,482014219001,237500.0,29.674421150013345,-95.48494272943783,317,14,9,10,19
844,889,890,1037,447,1037,84,953,948,878,17,1,46,0,6,5,810,53,757,754,703,12,1,36,0,2,3,447,430,17,482014219002,247000.0,29.669272431319765,-95.48151597947152,289,14,11,14,19
845,890,891,655,271,655,42,613,609,574,8,0,24,0,3,4,483,31,452,449,425,5,0,16,0,3,3,271,259,12,482014219003,252900.0,29.669568792371933,-95.48927252820329,297,11,9,8,19
846,891,892,683,287,683,64,619,611,544,21,1,45,0,0,8,541,43,498,494,434,17,1,42,0,0,4,287,280,7,482014220001,262100.0,29.6641715220266,-95.48665986037732,229,13,8,9,16
847,892,893,859,369,859,103,756,752,675,37,1,36,0,3,4,680,70,610,608,550,28,1,26,0,3,2,369,352,17,482014220002,219500.0,29.659788105877112,-95.488009701558,197,11,9,8,14
848,893,894,997,425,997,163,834,813,705,44,5,56,0,3,21,773,113,660,648,572,30,3,42,0,1,12,425,408,17,482014220003,180300.0,29.66211632785645,-95.47979135988996,218,14,13,16,16
849,894,895,1230,583,1230,489,741,727,467,226,1,29,1,3,14,938,304,634,624,419,179,1,22,1,2,10,583,520,63,482014221001,150900.0,29.654522940224982,-95.48254392750545,164,14,11,13,13
850,895,896,972,332,972,441,531,518,315,134,5,59,3,2,13,716,272,444,436,272,102,3,55,2,2,8,332,315,17,482014221002,135600.0,29.64583709226242,-95.48423653601192,141,11,8,10,9
851,896,897,1253,405,1253,708,545,528,274,200,6,48,0,0,17,906,471,435,424,232,145,6,41,0,0,11,405,381,24,482014221003,113900.0,29.64055127045865,-95.48923564886354,128,6,7,8,8
852,897,898,917,328,917,428,489,477,256,153,0,68,0,0,12,691,295,396,387,228,105,0,54,0,0,9,328,306,22,482014221004,116900.0,29.64661457241827,-95.48995779439316,145,8,8,7,9
853,898,899,917,398,917,198,719,702,573,89,0,39,0,1,17,745,138,607,596,499,66,0,30,0,1,11,398,383,15,482014221005,155000.0,29.653620824899424,-95.4892405216532,165,11,8,8,12
854,899,900,1644,1216,1644,308,1336,1311,67,1212,3,21,0,8,25,1230,203,1027,1011,61,921,3,21,0,5,16,1216,788,428,482014222001,102200.0,29.63778922673576,-95.50255606174852,131,6,8,6,7
855,900,901,2168,1003,2168,640,1528,1515,46,1449,2,17,0,1,13,1333,392,941,932,40,878,2,11,0,1,9,1003,703,300,482014222002,115600.0,29.63973444318094,-95.49538973736205,130,6,7,6,7
856,901,902,609,455,609,59,550,539,16,515,1,7,0,0,11,447,41,406,400,15,377,1,7,0,0,6,455,287,168,482014222003,27100.0,29.641909799537416,-95.50533203951905,141,6,9,6,7
857,902,903,1950,1131,1950,318,1632,1606,68,1505,4,29,0,0,26,1369,205,1164,1147,58,1070,1,18,0,0,17,1131,887,244,482014223011,,29.646460161577185,-95.50691478608437,144,8,10,6,7
858,903,904,1780,600,1780,611,1169,1139,67,1014,0,55,0,3,30,1226,411,815,794,58,694,0,41,0,1,21,600,547,53,482014223012,87600.0,29.649380983153154,-95.50185270221952,141,9,9,6,8
859,904,905,1345,526,1345,288,1057,1031,40,956,0,35,0,0,26,887,181,706,697,31,635,0,31,0,0,9,526,437,89,482014223013,95200.0,29.648350146777123,-95.50527435682326,145,9,10,6,7
860,905,906,2033,628,2033,809,1224,1184,27,581,5,556,6,9,40,1305,519,786,764,21,359,2,369,6,7,22,628,533,95,482014223014,101100.0,29.65322491877108,-95.50592536248656,158,11,10,6,9
861,906,907,2350,974,2350,619,1731,1708,372,1234,2,97,0,3,23,1748,441,1307,1295,335,872,2,85,0,1,12,974,908,66,482014223021,93800.0,29.64903203935705,-95.49713977953348,150,9,8,6,8
862,907,908,1325,622,1325,632,693,679,147,484,1,42,0,5,14,922,414,508,500,128,342,1,28,0,1,8,622,458,164,482014224011,99000.0,29.66220505690677,-95.50256705017966,186,11,10,7,13
863,908,909,1003,424,1003,368,635,627,49,566,0,12,0,0,8,676,212,464,461,43,412,0,6,0,0,3,424,400,24,482014224012,85300.0,29.6618234220298,-95.50543001284088,185,11,11,7,12
864,909,910,1582,867,1582,291,1291,1284,254,873,6,147,0,4,7,1228,200,1028,1022,246,620,6,146,0,4,6,867,827,40,482014224013,,29.659496403781063,-95.50703577423612,172,11,11,6,10
865,910,911,1526,518,1526,888,638,624,315,210,18,76,0,5,14,1035,543,492,482,271,144,14,51,0,2,10,518,480,38,482014224021,162400.0,29.65487586967181,-95.49557244227066,167,11,8,6,10
866,911,912,1982,679,1982,1247,735,722,314,349,1,53,3,2,13,1363,792,571,565,267,249,0,44,3,2,6,679,627,52,482014224022,148600.0,29.661623530005983,-95.49893971617584,197,11,9,7,14
867,912,913,1669,574,1669,1447,222,216,21,186,0,8,0,1,6,1091,942,149,146,17,120,0,8,0,1,3,574,490,84,482014224023,,29.655350946353416,-95.502958890159,155,11,9,6,9
868,913,914,897,394,897,192,705,698,559,68,1,68,0,2,7,726,140,586,585,479,50,1,55,0,0,1,394,383,11,482014224024,155900.0,29.661933076304265,-95.49449279466134,218,11,9,6,15
869,914,915,2290,787,2290,1447,843,812,122,543,2,142,0,3,31,1428,811,617,596,100,400,0,93,0,3,21,787,700,87,482014225001,204700.0,29.67359706604232,-95.50551212464909,257,11,12,7,15
870,915,916,1164,477,1164,160,1004,982,883,28,4,63,0,4,22,944,113,831,821,746,21,3,49,0,2,10,477,466,11,482014225002,223200.0,29.670087303310364,-95.49726300402703,294,11,9,7,17
871,916,917,1163,856,1163,525,638,622,133,422,0,55,0,12,16,780,347,433,421,102,281,0,32,0,6,12,856,408,448,482014225003,,29.668423867773303,-95.50420272909184,232,11,11,7,16
872,917,918,1030,562,1030,179,851,839,621,131,1,76,0,10,12,875,144,731,722,543,113,1,63,0,2,9,562,542,20,482014225004,198400.0,29.675633105989466,-95.49791224859077,313,11,10,7,19
873,918,919,1313,556,1313,444,869,846,686,79,3,72,0,6,23,1026,308,718,701,575,62,3,59,0,2,17,556,525,31,482014226001,133000.0,29.6878654763428,-95.4961256999922,352,10,9,7,22
874,919,920,890,403,890,335,555,545,504,32,1,5,0,3,10,686,222,464,460,432,20,1,5,0,2,4,403,371,32,482014226002,112000.0,29.685337240325367,-95.50126103637407,313,11,10,7,20
875,920,921,2371,1006,2371,890,1481,1453,944,449,2,55,1,2,28,1806,574,1232,1215,829,334,2,49,1,0,17,1006,825,181,482014226003,132900.0,29.67957143110636,-95.50157439022892,299,11,10,7,19
876,921,922,1806,684,1806,1370,436,428,260,134,0,27,0,7,8,1233,878,355,352,222,104,0,23,0,3,3,684,606,78,482014226004,106800.0,29.68490287991968,-95.50606622201823,297,11,11,7,19
877,922,923,1838,672,1838,1218,620,604,166,404,0,23,0,11,16,1214,779,435,431,142,264,0,16,0,9,4,672,617,55,482014227011,60000.0,29.69072342663552,-95.5055322451544,297,10,11,7,20
878,923,924,1250,397,1250,891,359,351,249,21,3,76,0,2,8,920,606,314,306,224,16,3,63,0,0,8,397,384,13,482014227012,108900.0,29.7032078247538,-95.49797896616089,357,9,9,7,23
879,924,925,1995,608,1995,1423,572,562,443,58,3,56,0,2,10,1435,950,485,479,381,43,1,52,0,2,6,608,579,29,482014227013,110600.0,29.696852128579582,-95.49893531788898,339,9,9,7,23
880,925,926,1816,611,1816,1141,675,646,453,89,3,98,0,3,29,1344,780,564,545,399,59,0,84,0,3,19,611,574,37,482014227021,107700.0,29.697997870063464,-95.50685414847422,300,9,10,7,20
881,926,927,1531,505,1531,907,624,606,433,78,8,81,1,5,18,1186,657,529,517,386,52,7,68,1,3,12,505,482,23,482014227022,110900.0,29.70012745207752,-95.51224160355824,298,9,10,8,20
882,927,928,1245,238,1245,172,1073,1052,800,178,2,67,2,3,21,1223,170,1053,1035,792,177,2,59,2,3,18,238,198,40,482014228001,325000.0,29.69259736370292,-95.51916329126004,291,10,11,8,19
883,928,929,539,208,539,308,231,226,99,87,3,35,0,2,5,410,225,185,183,86,61,2,34,0,0,2,208,180,28,482014228002,88600.0,29.690180806442346,-95.51146593114022,292,10,11,8,19
884,929,930,1837,722,1837,887,950,924,474,309,4,137,0,0,26,1410,599,811,800,426,250,3,121,0,0,11,722,667,55,482014228003,119000.0,29.68665731506209,-95.51808950898176,290,10,11,8,18
885,930,931,1295,549,1295,1143,152,147,24,107,3,10,0,3,5,783,671,112,110,16,80,1,10,0,3,2,549,331,218,482014228004,,29.68715320858468,-95.511508198864,292,10,11,8,18
886,931,932,2707,1202,2707,1565,1142,1106,231,801,13,60,0,1,36,1904,1024,880,851,222,567,8,53,0,1,29,1202,1044,158,482014229001,83500.0,29.68484995711934,-95.52650167039651,277,10,7,8,17
887,932,933,2320,838,2320,1426,894,869,353,403,2,106,0,5,25,1646,934,712,694,305,296,2,89,0,2,18,838,783,55,482014229002,110900.0,29.68051118315934,-95.5330768879128,258,10,6,8,16
888,933,934,2013,1127,2013,1162,851,833,151,648,1,18,1,14,18,1402,726,676,664,133,507,1,15,1,7,12,1127,739,388,482014230001,193400.0,29.679234213345115,-95.51124483982632,278,11,11,8,18
889,934,935,929,567,929,545,384,373,43,321,0,9,0,0,11,684,372,312,304,38,257,0,9,0,0,8,567,434,133,482014230002,,29.67586829760613,-95.5225178415738,257,10,11,8,15
890,935,936,1753,661,1753,1262,491,482,349,73,4,44,0,12,9,1259,834,425,420,313,55,4,42,0,6,5,661,609,52,482014230003,132900.0,29.68092336038784,-95.51427609829472,278,11,11,8,18
891,936,937,773,388,773,242,531,525,29,489,0,5,1,1,6,522,169,353,351,27,320,0,3,1,0,2,388,316,72,482014231001,39400.0,29.668592640487397,-95.54549284359165,218,9,7,8,13
892,937,938,2388,751,2388,1937,451,445,26,400,1,14,0,4,6,1515,1215,300,298,21,266,0,8,0,3,2,751,697,54,482014231002,,29.674794058770303,-95.53300690211276,234,10,7,8,14
893,938,939,1618,533,1618,702,916,890,376,429,1,81,0,3,26,1210,466,744,723,331,314,1,75,0,2,21,533,516,17,482014232011,116100.0,29.661035078980635,-95.54618043902336,177,10,7,9,11
894,939,940,1615,538,1615,604,1011,996,352,541,0,96,1,6,15,1160,394,766,757,308,370,0,77,1,1,9,538,507,31,482014232012,112900.0,29.66073400153604,-95.53894485785229,177,10,7,9,10
895,940,941,2742,1138,2742,1466,1276,1255,161,1067,7,20,0,0,21,1860,960,900,891,120,747,6,18,0,0,9,1138,989,149,482014232021,65400.0,29.668312587893396,-95.53024065877274,212,10,7,8,13
896,941,942,2554,1228,2554,888,1666,1624,250,1172,1,197,0,4,42,1858,603,1255,1228,225,840,1,161,0,1,27,1228,1006,222,482014232022,117000.0,29.66088636398764,-95.53217958904204,161,10,7,8,11
897,942,943,1693,742,1693,934,759,748,59,670,1,16,0,2,11,1115,619,496,488,44,429,1,14,0,0,8,742,591,151,482014232023,157600.0,29.669683415407803,-95.5334781384421,221,10,7,8,13
898,943,944,1255,532,1255,383,872,860,551,249,5,47,1,7,12,976,262,714,705,468,188,5,41,1,2,9,532,510,22,482014233011,176900.0,29.6701764143823,-95.52238644069315,237,10,10,8,14
899,944,945,1230,740,1230,210,1020,1009,625,294,3,87,0,0,11,986,142,844,839,552,216,1,70,0,0,5,740,512,228,482014233012,170300.0,29.67035786046178,-95.51219647119272,240,11,12,8,15
900,945,946,1216,780,1216,479,737,726,145,516,0,53,1,11,11,873,302,571,563,131,381,0,47,1,3,8,780,539,241,482014233013,153100.0,29.66680687070135,-95.52153945194792,218,10,10,8,14
901,946,947,1283,508,1283,192,1091,1080,420,576,1,75,0,8,11,1002,139,863,854,361,429,1,58,0,5,9,508,475,33,482014233021,139000.0,29.66273969921579,-95.51654107886078,178,10,11,8,12
902,947,948,1681,994,1681,267,1414,1395,285,1074,2,30,0,4,19,1371,170,1201,1188,260,895,2,27,0,4,13,994,922,72,482014233022,145600.0,29.660150134084525,-95.51088700333077,172,11,11,8,10
903,948,949,2159,902,2159,222,1937,1895,311,1399,5,173,0,7,42,1577,161,1416,1387,241,977,3,160,0,6,29,902,843,59,482014233023,105900.0,29.65965676714168,-95.5224816596494,167,10,10,7,10
904,949,950,2012,793,2012,394,1618,1600,101,1415,0,83,0,1,18,1474,257,1217,1207,87,1040,0,79,0,1,10,793,728,65,482014234011,121500.0,29.645267458396464,-95.51488102103536,140,8,10,6,7
905,950,951,1762,683,1762,341,1421,1402,428,907,4,46,9,8,19,1190,201,989,976,271,660,2,39,2,2,13,683,647,36,482014234012,136800.0,29.65368569210282,-95.51252899595534,154,11,10,6,9
906,951,952,1379,436,1379,170,1209,1186,344,688,1,149,0,4,23,1016,115,901,887,240,517,1,126,0,3,14,436,424,12,482014234013,168500.0,29.651063797661337,-95.51967266950815,161,9,10,6,8
907,952,953,2836,821,2836,644,2192,2172,75,1313,2,781,0,1,20,1990,432,1558,1548,70,863,2,613,0,0,10,821,804,17,482014234021,129300.0,29.650104973269737,-95.53186290391764,152,9,6,6,8
908,953,954,1371,538,1371,248,1123,1101,82,965,0,52,0,2,22,1007,154,853,840,80,711,0,49,0,0,13,538,518,20,482014234022,101500.0,29.64519233245052,-95.52485734803328,140,7,7,6,7
909,954,955,1927,722,1927,404,1523,1495,615,581,1,286,0,12,28,1498,268,1230,1209,532,440,1,232,0,4,21,722,698,24,482014235001,139100.0,29.650951724909973,-95.54119746270074,178,8,7,7,8
910,955,956,1226,427,1226,460,766,759,48,630,4,70,0,7,7,822,291,531,526,46,421,3,52,0,4,5,427,398,29,482014236001,110300.0,29.641873463999787,-95.53224674373078,140,5,6,6,7
911,957,958,700,217,700,213,487,484,59,401,2,22,0,0,3,496,141,355,353,47,286,2,18,0,0,2,217,198,19,482014236004,110800.0,29.64266503934108,-95.51234119247732,140,6,9,6,7
912,958,959,791,568,791,88,703,696,626,34,0,36,0,0,7,713,71,642,635,574,27,0,34,0,0,7,568,491,77,482014301001,161500.0,29.777200596141,-95.45718930135024,628,7,17,20,34
913,959,960,1695,804,1695,155,1540,1496,1319,44,0,132,0,1,44,1365,123,1242,1213,1084,29,0,99,0,1,29,804,696,108,482014301002,909500.0,29.77323890292862,-95.46638080886255,588,8,18,23,32
914,960,961,1483,933,1483,416,1067,1041,786,100,1,150,0,4,26,1229,320,909,896,684,82,1,125,0,4,13,933,822,111,482014301003,747500.0,29.781490029574336,-95.47287909346224,542,4,13,13,31
915,961,962,688,385,688,174,514,507,408,27,2,68,0,2,7,537,136,401,397,319,27,1,48,0,2,4,385,334,51,482014301004,930600.0,29.78140164718094,-95.4814013751736,516,6,9,10,33
916,962,963,1092,774,1092,104,988,975,891,15,0,63,1,5,13,972,72,900,892,825,14,0,48,1,4,8,774,607,167,482014301005,133800.0,29.78189447414409,-95.46172930666174,588,5,16,14,31
917,963,964,1380,796,1380,256,1124,1107,940,31,4,126,0,6,17,1109,187,922,907,781,25,4,94,0,3,15,796,706,90,482014302001,848500.0,29.775920462611545,-95.48474763645014,520,9,7,12,34
918,964,965,896,345,896,93,803,789,529,16,3,238,0,3,14,640,66,574,566,396,8,2,159,0,1,8,345,327,18,482014307001,235200.0,29.77598471955215,-95.53478872941076,314,7,5,8,21
919,965,966,1338,959,1338,183,1155,1139,808,38,5,282,0,6,16,1139,142,997,985,746,30,5,200,0,4,12,959,856,103,482014307002,248300.0,29.78084591604793,-95.53836029778064,279,6,4,6,20
920,966,967,1050,369,1050,34,1016,1014,943,1,1,67,0,2,2,719,19,700,698,653,1,1,43,0,0,2,369,359,10,482014307003,567300.0,29.771220484113783,-95.54232335357278,306,6,6,8,21
921,967,968,2900,1490,2900,188,2712,2668,2209,45,8,400,5,1,44,2097,122,1975,1941,1600,36,8,292,5,0,34,1490,1138,352,482014308001,459300.0,29.777690196681498,-95.55198798730028,258,6,5,9,18
922,968,969,1448,594,1448,80,1368,1354,1131,3,0,211,5,4,14,1023,52,971,966,823,2,0,134,3,4,5,594,568,26,482014308002,347900.0,29.77174870379674,-95.55512276450123,262,6,5,9,17
923,969,970,1864,1017,1864,120,1744,1734,1640,4,1,87,0,2,10,1560,94,1466,1458,1382,4,1,69,0,2,8,1017,957,60,482014309001,335500.0,29.753002909396045,-95.53149335576867,343,7,7,9,23
924,970,971,730,287,730,40,690,686,627,5,4,48,0,2,4,532,29,503,499,461,2,2,32,0,2,4,287,270,17,482014309002,612600.0,29.75594030944622,-95.54031246430144,322,6,7,9,22
925,971,972,1433,664,1433,116,1317,1290,1059,10,0,217,1,3,27,1144,78,1066,1048,891,6,0,148,1,2,18,664,637,27,482014309003,408200.0,29.760843648428494,-95.54828121627683,292,6,7,10,20
926,972,973,1743,799,1743,185,1558,1507,937,27,5,532,0,6,51,1296,142,1154,1114,736,20,3,354,0,1,40,799,742,57,482014309004,198500.0,29.76665281200756,-95.55830554315622,260,6,5,7,17
927,973,974,1712,959,1712,275,1437,1408,1145,90,6,166,0,1,29,1495,207,1288,1267,1050,74,6,137,0,0,21,959,910,49,482014310001,171800.0,29.74574260578326,-95.55570525573098,270,6,6,9,19
928,974,975,964,405,964,59,905,898,838,9,1,45,2,3,7,744,41,703,696,652,7,1,34,2,0,7,405,390,15,482014310002,418300.0,29.75706568714609,-95.55259685939002,275,5,7,10,18
929,975,976,1390,769,1390,139,1251,1239,1058,61,0,117,0,3,12,1160,112,1048,1043,899,46,0,95,0,3,5,769,646,123,482014310003,329400.0,29.743892976525377,-95.54464006572658,312,7,7,8,22
930,976,977,1173,521,1173,63,1110,1095,1024,16,2,52,0,1,15,940,51,889,881,828,9,2,41,0,1,8,521,507,14,482014310004,340000.0,29.748878060434453,-95.55068545434791,287,6,7,9,21
931,977,978,680,412,680,31,649,642,601,6,0,32,0,3,7,658,30,628,621,583,6,0,31,0,1,7,412,391,21,482014311011,319500.0,29.748983675823546,-95.5355099790656,338,8,7,8,23
932,978,979,1643,1136,1643,523,1120,1069,407,519,0,129,0,14,51,1421,412,1009,967,380,463,0,110,0,14,42,1136,954,182,482014311012,,29.739397171832795,-95.53529192515998,326,9,6,8,21
933,979,980,980,726,980,166,814,778,655,56,2,63,1,1,36,898,148,750,724,616,50,2,54,1,1,26,726,632,94,482014311013,92300.0,29.74446422370539,-95.5366114828827,331,9,7,8,22
934,980,981,1899,1195,1899,413,1486,1444,787,513,7,127,0,10,42,1614,313,1301,1268,721,412,7,119,0,9,33,1195,1032,163,482014311021,1000001.0,29.742692659751405,-95.53157670778052,338,9,6,8,22
935,981,982,1437,1067,1437,191,1246,1224,876,119,2,215,0,12,22,1335,172,1163,1144,823,114,2,199,0,6,19,1067,968,99,482014311022,169400.0,29.74053582782977,-95.52562819694816,342,9,6,8,23
936,982,983,1468,946,1468,216,1252,1223,809,179,2,232,0,1,29,1339,184,1155,1133,778,151,1,202,0,1,22,946,860,86,482014312011,193500.0,29.74083008984477,-95.5144864656876,353,9,10,10,23
937,983,984,2590,1533,2590,821,1769,1684,942,450,3,276,0,13,85,2202,628,1574,1509,851,395,0,250,0,13,65,1533,1403,130,482014312012,,29.739555519429477,-95.51839487882012,349,9,10,8,23
938,984,985,1773,1054,1773,467,1306,1260,778,313,4,157,0,8,46,1473,367,1106,1078,682,252,4,135,0,5,28,1054,918,136,482014312021,69700.0,29.74152336832323,-95.5087789352879,373,9,10,9,24
939,985,986,528,283,528,55,473,469,440,14,0,13,0,2,4,419,47,372,370,343,12,0,13,0,2,2,283,263,20,482014312022,190900.0,29.7478693552198,-95.50487226279786,390,8,11,9,28
940,986,987,618,311,618,45,573,568,541,2,2,22,1,0,5,532,31,501,499,476,2,2,18,1,0,2,311,297,14,482014312023,294800.0,29.746154873996705,-95.5028962614212,399,8,10,9,27
941,987,988,1673,1157,1673,317,1356,1325,639,205,6,474,0,1,31,1477,279,1198,1172,590,190,5,386,0,1,26,1157,1005,152,482014312024,149500.0,29.740592051424414,-95.5030167283669,376,9,9,9,25
942,988,989,1580,1018,1580,420,1160,1121,757,213,5,144,0,2,39,1366,335,1031,1003,693,180,5,123,0,2,28,1018,900,118,482014313011,119100.0,29.74055436465944,-95.49886746408892,421,9,9,9,27
943,989,990,1190,821,1190,354,836,809,541,155,3,102,0,8,27,1036,296,740,720,506,123,3,80,0,8,20,821,753,68,482014313012,79400.0,29.747148100195812,-95.49932212921392,447,8,10,9,29
944,990,991,1746,1059,1746,520,1226,1190,840,205,7,131,1,6,36,1509,418,1091,1063,777,166,4,110,0,6,28,1059,977,82,482014313013,171000.0,29.74447007491759,-95.49638745422344,450,9,10,9,29
945,991,992,1446,970,1446,201,1245,1206,993,77,0,133,0,3,39,1255,155,1100,1073,891,64,0,116,0,2,27,970,816,154,482014313021,350700.0,29.741916870632902,-95.4871219437114,516,10,8,12,30
946,992,993,1512,622,1512,150,1362,1355,1302,20,1,23,0,9,7,1039,100,939,934,888,17,1,20,0,8,5,622,593,29,482014313022,446900.0,29.742572418818465,-95.49283024387104,486,9,9,9,28
947,993,994,971,412,971,61,910,899,840,18,0,41,0,0,11,698,41,657,648,612,12,0,24,0,0,9,412,384,28,482014313023,481800.0,29.74690803241356,-95.4897147912694,537,8,10,9,31
948,994,995,1281,982,1281,271,1010,980,784,70,1,118,3,4,30,1147,218,929,901,731,62,1,104,3,0,28,982,833,149,482014314011,108600.0,29.742134602627395,-95.48386019302524,529,12,9,13,31
949,995,996,1058,771,1058,268,790,769,578,82,2,102,1,4,21,933,222,711,695,537,66,2,85,1,4,16,771,671,100,482014314012,216700.0,29.747929627883003,-95.48420366879228,555,10,9,13,34
950,996,997,1870,1435,1870,246,1624,1577,1229,105,2,231,0,10,47,1738,223,1515,1474,1174,91,2,200,0,7,41,1435,1276,159,482014314021,126800.0,29.74357756296906,-95.4810601548486,559,12,13,17,31
951,997,998,1339,921,1339,199,1140,1114,864,75,0,168,0,7,26,1219,170,1049,1026,817,66,0,137,0,6,23,921,799,122,482014314022,167900.0,29.74421119912496,-95.47842500518465,570,10,15,20,33
952,998,999,894,732,894,103,791,781,712,19,1,49,0,0,10,830,90,740,731,670,16,1,44,0,0,9,732,619,113,482014315011,149400.0,29.759740592608903,-95.47984829334172,588,9,16,20,36
953,999,1000,1515,1153,1515,168,1347,1323,1191,23,4,101,2,2,24,1387,152,1235,1217,1099,22,3,89,2,2,18,1153,1021,132,482014315012,189800.0,29.754572918224444,-95.48426123850824,552,9,9,14,35
954,1000,1001,1302,898,1302,153,1149,1116,892,44,1,173,0,6,33,1164,128,1036,1014,828,39,1,142,0,4,22,898,823,75,482014315013,166500.0,29.75339699412427,-95.47996547566854,586,9,15,19,35
955,1001,1002,1138,837,1138,161,977,954,795,31,1,126,0,1,23,1056,137,919,901,761,28,1,110,0,1,18,837,747,90,482014315021,592900.0,29.75287534244943,-95.49816244233256,449,7,10,10,30
956,1002,1003,1036,644,1036,71,965,951,862,12,1,73,0,3,14,942,60,882,874,801,8,1,63,0,1,8,644,601,43,482014315022,342100.0,29.75414004003165,-95.48734290992942,539,8,9,13,34
957,1003,1004,1297,472,1297,78,1219,1214,1161,4,0,49,0,0,5,869,42,827,824,791,2,0,31,0,0,3,472,448,24,482014315023,616700.0,29.753618855044,-95.49207256901671,515,7,10,10,32
958,1004,1005,1050,458,1050,66,984,983,951,9,1,22,0,0,1,874,44,830,829,804,6,1,18,0,0,1,458,438,20,482014316001,927000.0,29.767584248506623,-95.47324736076732,570,7,18,22,32
959,1005,1006,959,583,959,52,907,904,874,10,2,14,0,4,3,814,48,766,764,736,10,2,14,0,2,2,583,504,79,482014316002,1000001.0,29.763294545343,-95.48320068858526,538,9,13,15,36
960,1006,1007,1343,703,1343,106,1237,1216,1156,22,9,25,0,4,21,1156,88,1068,1054,1006,21,5,19,0,3,14,703,639,64,482014316003,525000.0,29.76323949942597,-95.49014425987488,513,7,11,10,34
961,1007,1008,1597,838,1597,148,1449,1419,1321,31,0,67,0,0,30,1315,105,1210,1189,1112,24,0,53,0,0,21,838,718,120,482014317001,662700.0,29.75336099712506,-95.47059381338433,609,7,17,24,34
962,1008,1009,1734,1189,1734,166,1568,1542,1396,58,0,87,0,1,26,1594,135,1459,1439,1313,50,0,75,0,1,20,1189,991,198,482014317002,595700.0,29.76123381622569,-95.46192746789332,621,8,21,25,35
963,1009,1010,1260,601,1260,58,1202,1183,1128,1,1,53,0,0,19,1027,42,985,977,933,1,1,42,0,0,8,601,532,69,482014317003,1000001.0,29.7595910892035,-95.4703845814016,613,7,18,24,35
964,1010,1011,725,408,725,40,685,676,626,7,0,42,0,1,9,646,33,613,608,569,7,0,31,0,1,5,408,376,32,482014318011,372000.0,29.745516612586,-95.4695168823894,604,9,18,24,32
965,1011,1012,1073,652,1073,113,960,945,440,34,3,460,0,8,15,882,96,786,772,352,32,0,380,0,8,14,652,536,116,482014318012,,29.740512788646942,-95.47389098741992,563,10,16,22,29
966,1012,1013,1169,744,1169,161,1008,986,833,35,2,114,0,2,22,1010,137,873,859,726,32,1,99,0,1,14,744,679,65,482014318013,443400.0,29.746014046999782,-95.47457003279848,580,9,17,22,32
967,1013,1014,1303,1088,1303,160,1143,1128,900,77,2,145,0,4,15,1244,145,1099,1087,866,73,2,142,0,4,12,1088,912,176,482014318021,531300.0,29.752635232608256,-95.45866621732326,629,8,19,25,35
968,1014,1015,2392,1969,2392,470,1922,1863,1346,160,8,336,1,12,59,2131,401,1730,1684,1218,138,7,312,1,8,46,1969,1473,496,482014318022,261500.0,29.74566452512478,-95.46217185290078,613,10,20,25,32
969,1015,1016,738,667,738,83,655,643,563,30,0,48,2,0,12,707,76,631,621,545,28,0,46,2,0,10,667,505,162,482014319001,149000.0,29.73790090088593,-95.46394192512146,583,10,18,25,30
970,1016,1017,3048,2309,3048,551,2497,2446,1673,270,2,492,0,9,51,2850,506,2344,2306,1601,247,2,447,0,9,38,2309,1974,335,482014319002,274600.0,29.73142018122842,-95.46458110048002,557,10,18,23,30
971,1017,1018,1655,1201,1655,588,1067,1042,566,343,0,124,2,7,25,1453,477,976,954,521,318,0,107,2,6,22,1201,993,208,482014320011,,29.734706510921068,-95.48700888703556,502,10,8,10,30
972,1018,1019,1809,891,1809,317,1492,1449,1005,86,0,344,0,14,43,1450,232,1218,1193,858,62,0,264,0,9,25,891,787,104,482014320012,458600.0,29.73468892938209,-95.4762225440516,539,10,15,20,31
973,1019,1020,1262,681,1262,792,470,457,150,269,0,38,0,0,13,1011,617,394,382,111,234,0,37,0,0,12,681,541,140,482014320021,,29.733324225793574,-95.49622103805632,428,9,9,7,27
974,1020,1021,1532,987,1532,935,597,564,241,258,7,48,1,9,33,1330,780,550,519,222,237,5,46,1,8,31,987,795,192,482014320022,,29.73552034112929,-95.49792302225852,423,9,9,7,27
975,1021,1022,1940,1116,1940,842,1098,1039,603,281,3,149,0,3,59,1611,628,983,936,551,253,2,128,0,2,47,1116,1007,109,482014320023,94800.0,29.73519448533225,-95.4922060046448,476,9,9,7,28
976,1022,1023,2167,1291,2167,852,1315,1270,513,532,6,208,0,11,45,1820,671,1149,1118,463,461,5,182,0,7,31,1291,1145,146,482014321001,,29.73335290446731,-95.51743804138547,340,9,10,8,23
977,1023,1024,2221,909,2221,1064,1157,1100,417,363,7,304,2,7,57,1756,796,960,914,349,304,3,252,2,4,46,909,867,42,482014321002,220000.0,29.7345921003173,-95.50920929264797,360,9,10,7,23
978,1024,1025,666,287,666,47,619,602,557,7,3,35,0,0,17,522,37,485,474,435,6,1,32,0,0,11,287,274,13,482014321003,257100.0,29.732438736727875,-95.50609768434708,354,9,10,7,24
979,1025,1026,986,467,986,200,786,762,655,41,2,64,0,0,24,816,154,662,648,561,30,2,55,0,0,14,467,442,25,482014322001,179200.0,29.73321018005597,-95.53575617510955,324,9,6,8,21
980,1026,1027,669,360,669,127,542,536,409,74,0,53,0,0,6,570,100,470,466,358,62,0,46,0,0,4,360,330,30,482014322002,158900.0,29.731491309073952,-95.52929740319048,336,9,6,8,22
981,1027,1028,2388,1278,2388,1074,1314,1274,506,573,2,190,0,3,40,1958,829,1129,1096,455,464,2,172,0,3,33,1278,1166,112,482014322003,89800.0,29.73395152203976,-95.52455267928192,339,9,7,8,22
982,1028,1029,1865,1014,1865,685,1180,1151,324,702,5,114,0,6,29,1445,503,942,926,292,525,4,99,0,6,16,1014,911,103,482014323001,130500.0,29.733812351268373,-95.54131883589405,312,7,6,8,21
983,1029,1030,1089,626,1089,446,643,620,176,345,4,90,2,3,23,893,332,561,540,173,284,2,78,2,1,21,626,594,32,482014323002,,29.729042578883625,-95.54137419254496,303,7,6,8,19
984,1030,1031,2174,1102,2174,904,1270,1227,192,937,15,77,0,6,43,1615,631,984,964,171,712,15,63,0,3,20,1102,977,125,482014323003,,29.730781249372637,-95.54546168578884,302,7,6,8,20
985,1031,1032,1393,910,1393,377,1016,993,309,429,6,240,3,6,23,1134,273,861,845,285,347,3,203,3,4,16,910,715,195,482014323004,326000.0,29.73287852521027,-95.55154430144022,273,7,6,9,18
986,1032,1033,1408,914,1408,473,935,909,298,404,4,197,0,6,26,1153,362,791,772,272,322,1,174,0,3,19,914,766,148,482014324001,46200.0,29.721032415659483,-95.54422906793368,297,8,6,8,20
987,1033,1034,2124,1208,2124,874,1250,1204,205,885,1,103,0,10,46,1630,617,1013,976,181,695,1,93,0,6,37,1208,1049,159,482014324002,,29.72377167144239,-95.55196512072698,263,8,6,9,17
988,1034,1035,2016,1111,2016,777,1239,1192,437,632,2,112,0,9,47,1572,559,1013,982,373,500,1,99,0,9,31,1111,995,116,482014324003,98900.0,29.725384096515388,-95.54226194858242,304,8,6,8,19
989,1035,1036,1803,938,1803,1068,735,725,217,461,2,41,0,4,10,1332,732,600,593,195,359,1,36,0,2,7,938,757,181,482014325001,257100.0,29.72485856576561,-95.5248436259312,327,10,8,8,21
990,1036,1037,1953,893,1953,1135,818,796,289,400,2,99,0,6,22,1430,770,660,646,257,305,1,80,0,3,14,893,789,104,482014325002,77800.0,29.724264011709646,-95.53177224823672,322,10,6,8,21
991,1037,1038,1773,816,1773,701,1072,1034,549,366,0,107,0,12,38,1311,478,833,811,443,274,0,86,0,8,22,816,730,86,482014325003,113800.0,29.724399373664102,-95.5364235602187,317,10,6,8,20
992,1038,1039,702,292,702,76,626,622,572,10,4,35,1,0,4,552,52,500,497,457,8,4,27,1,0,3,292,280,12,482014326001,283300.0,29.72829116679906,-95.50540238909925,335,9,11,7,21
993,1039,1040,1186,610,1186,467,719,699,271,379,0,41,2,6,20,883,318,565,551,230,284,0,33,2,2,14,610,525,85,482014326002,171700.0,29.72501810917455,-95.5125144993046,334,10,11,8,21
994,1040,1041,2490,844,2490,2381,109,105,47,43,6,9,0,0,4,1838,1753,85,82,32,37,5,8,0,0,3,844,666,178,482014327011,,29.72467516728364,-95.4952546166857,412,10,10,6,24
995,1041,1042,2851,1032,2851,2594,257,254,89,142,1,21,0,1,3,2173,1985,188,188,66,103,0,18,0,1,0,1032,814,218,482014327012,48800.0,29.727133569818964,-95.49438248826893,418,10,10,6,25
996,1042,1043,1380,713,1380,937,443,435,247,134,11,36,1,6,8,1013,635,378,371,205,119,9,34,1,3,7,713,537,176,482014327013,122100.0,29.72993127435984,-95.49476920311965,420,9,9,6,27
997,1043,1044,1493,876,1493,315,1178,1150,954,99,3,88,0,6,28,1294,266,1028,1005,831,94,3,73,0,4,23,876,810,66,482014327021,313500.0,29.72882980761432,-95.47235331665466,503,10,17,19,25
998,1044,1045,1891,661,1891,1478,413,406,231,92,0,77,1,5,7,1364,1002,362,357,204,78,0,71,1,3,5,661,635,26,482014327022,110700.0,29.72891502790249,-95.482215421665,475,12,12,14,27
999,1045,1046,1581,917,1581,591,990,963,284,500,4,170,1,4,27,1188,401,787,766,240,371,0,151,1,3,21,917,713,204,482014328011,98800.0,29.71824798967883,-95.50679346755244,333,10,11,8,22
1000,1046,1047,1800,855,1800,1025,775,764,169,499,5,84,0,7,11,1294,699,595,586,136,370,5,69,0,6,9,855,703,152,482014328012,55000.0,29.7149098657778,-95.51574993865134,330,10,11,9,22
1001,1047,1048,1386,550,1386,812,574,553,136,256,3,148,0,10,21,955,536,419,407,102,171,3,123,0,8,12,550,461,89,482014328013,108200.0,29.715841966207822,-95.51844373060756,330,10,11,9,22
1002,1048,1049,1574,656,1574,1307,267,261,60,181,3,17,0,0,6,1098,913,185,182,46,118,3,15,0,0,3,656,476,180,482014328021,,29.711301254497982,-95.51967316923502,318,10,11,9,21
1003,1049,1050,2344,1287,2344,1353,991,965,325,322,1,315,0,2,26,1770,888,882,863,314,254,1,293,0,1,19,1287,1045,242,482014328022,33300.0,29.71098188230893,-95.51138575863726,317,10,11,9,21
1004,1050,1051,1495,709,1495,1016,479,465,164,202,0,98,0,1,14,1125,708,417,405,154,162,0,88,0,1,12,709,572,137,482014328023,43100.0,29.71138949475252,-95.51687318265384,318,10,11,9,21
1005,1051,1052,203,143,203,74,129,122,31,52,1,30,1,7,7,168,56,112,107,30,45,1,27,1,3,5,143,100,43,482014328024,,29.706139180851597,-95.51653266092391,294,9,10,8,20
1006,1052,1053,2638,910,2638,2136,502,493,108,325,2,41,0,17,9,1770,1399,371,364,82,236,2,36,0,8,7,910,817,93,482014329011,,29.717715901999927,-95.52994521411236,322,10,6,9,21
1007,1053,1054,846,304,846,460,386,377,228,45,0,102,0,2,9,651,313,338,332,205,32,0,93,0,2,6,304,292,12,482014329012,141900.0,29.712452413521827,-95.52266671294052,323,10,10,9,20
1008,1054,1055,1333,944,1333,901,432,419,226,76,0,109,8,0,13,1016,666,350,342,187,55,0,93,7,0,8,944,457,487,482014329021,166500.0,29.70999321497004,-95.5367437073396,283,9,6,9,19
1009,1055,1056,1999,967,1999,1379,620,607,90,381,4,131,0,1,13,1378,912,466,459,78,274,2,105,0,0,7,967,648,319,482014329022,145200.0,29.707182109596307,-95.52608901384464,286,9,6,9,20
1010,1056,1057,1144,607,1144,193,951,938,282,163,1,488,4,0,13,951,135,816,805,250,125,1,426,3,0,11,607,544,63,482014329023,73800.0,29.710602127541883,-95.53048176282287,298,9,6,9,20
1011,1057,1058,1061,429,1061,346,715,694,53,145,0,491,5,0,21,787,230,557,541,45,126,0,368,2,0,16,429,398,31,482014330011,9999.0,29.71498400794359,-95.55257675337457,265,7,6,9,17
1012,1058,1059,1913,593,1913,1676,237,233,65,93,2,61,10,2,4,1352,1130,222,218,61,89,2,55,10,1,4,593,535,58,482014330012,,29.71638104988273,-95.54299117686352,303,8,6,8,20
1013,1059,1060,2384,991,2384,1248,1136,1087,65,99,4,911,3,5,49,1599,872,727,688,54,72,1,555,3,3,39,991,729,262,482014330013,,29.71660058630725,-95.5438682628467,298,8,6,8,20
1014,1060,1061,1507,595,1507,742,765,759,20,55,5,679,0,0,6,1113,493,620,615,18,29,5,563,0,0,5,595,477,118,482014330021,62200.0,29.707714003256942,-95.54239741829866,266,8,5,9,18
1015,1061,1062,3352,1378,3352,2753,599,591,93,450,3,37,2,6,8,2442,1999,443,436,66,332,1,32,2,3,7,1378,1146,232,482014330022,,29.710704488771015,-95.54176001829568,278,8,6,9,19
1016,1062,1063,1908,880,1908,235,1673,1638,40,481,1,1115,0,1,35,1422,136,1286,1266,28,255,1,981,0,1,20,880,787,93,482014330031,75900.0,29.708020064690317,-95.55251580680068,235,7,5,8,15
1017,1063,1064,2923,1201,2923,1981,942,916,72,270,10,564,0,0,26,1976,1254,722,701,53,184,10,454,0,0,21,1201,970,231,482014330032,21400.0,29.709602573304142,-95.54724955308532,249,9,6,8,18
1018,1064,1065,1850,592,1850,1102,748,727,38,653,3,19,0,14,21,1077,612,465,452,20,407,1,18,0,6,13,592,559,33,482014331001,,29.700626621220824,-95.55469277190493,228,7,4,7,15
1019,1065,1066,1898,764,1898,1466,432,424,31,314,2,74,0,3,8,1181,850,331,326,28,225,2,69,0,2,5,764,550,214,482014331002,59200.0,29.692796139735268,-95.55458945896451,217,8,5,7,14
1020,1066,1067,2156,899,2156,800,1356,1321,154,605,5,552,0,5,35,1552,498,1054,1025,141,407,3,473,0,1,29,899,795,104,482014332011,113000.0,29.69971976440411,-95.55051146018796,233,8,5,7,16
1021,1067,1068,1620,670,1620,685,935,924,214,513,0,190,0,7,11,1173,466,707,701,200,346,0,152,0,3,6,670,621,49,482014332012,90900.0,29.692593484833804,-95.54884718613415,227,9,6,7,16
1022,1068,1069,1342,521,1342,221,1121,1103,307,81,0,713,2,0,18,1121,169,952,941,287,57,0,595,2,0,11,521,476,45,482014332013,142500.0,29.700161057752734,-95.54687408110055,242,9,5,7,18
1023,1069,1070,1576,579,1576,701,875,863,310,99,1,452,0,1,12,1187,467,720,715,273,62,1,379,0,0,5,579,519,60,482014332021,135700.0,29.70097677988169,-95.5412030087696,259,8,5,8,18
1024,1070,1071,2760,831,2760,1731,1029,1001,329,198,3,464,0,7,28,1872,1060,812,794,294,132,2,365,0,1,18,831,763,68,482014332022,117800.0,29.693942776955648,-95.54129113547724,248,9,6,8,17
1025,1071,1072,1973,657,1973,837,1136,1098,537,150,0,408,0,3,38,1502,567,935,917,478,97,0,339,0,3,18,657,628,29,482014333001,136000.0,29.70091970083551,-95.532756078963,282,9,5,8,18
1026,1072,1073,1747,623,1747,704,1043,1028,656,83,0,287,0,2,15,1355,478,877,871,562,65,0,242,0,2,6,623,594,29,482014333002,132100.0,29.700407309065536,-95.52381678716266,293,9,7,8,19
1027,1073,1074,1476,522,1476,511,965,953,520,101,2,326,1,3,12,1209,367,842,834,480,78,2,272,1,1,8,522,495,27,482014333003,137600.0,29.693438975273743,-95.53124919203366,272,10,6,8,18
1028,1074,1075,3021,1283,3021,1910,1111,1083,251,634,2,192,0,4,28,2216,1337,879,863,216,476,1,166,0,4,16,1283,1162,121,482014334001,116100.0,29.689246055007967,-95.5454765036888,243,9,6,7,17
1029,1075,1076,1385,571,1385,601,784,761,218,348,1,188,0,6,23,1055,416,639,628,201,258,1,165,0,3,11,571,530,41,482014334002,77600.0,29.6853423981215,-95.54026019836812,254,10,6,8,16
1030,1076,1077,2216,702,2216,1504,712,696,39,636,0,17,0,4,16,1469,1050,419,412,29,367,0,14,0,2,7,702,673,29,482014335011,,29.687384976154306,-95.5544687346584,206,8,5,7,14
1031,1077,1078,2738,828,2738,2535,203,199,65,110,1,21,0,2,4,1838,1692,146,145,43,85,1,16,0,0,1,828,771,57,482014335012,12500.0,29.679698362846683,-95.54593227795756,220,9,6,7,15
1032,1078,1079,1207,574,1207,746,461,459,46,395,0,18,0,0,2,845,484,361,360,41,302,0,17,0,0,1,574,480,94,482014335013,24300.0,29.67802723232852,-95.55136197036131,198,9,6,8,12
1033,1079,1080,1917,872,1917,1198,719,710,48,538,0,120,0,4,9,1324,785,539,535,42,390,0,101,0,2,4,872,726,146,482014335021,,29.681414259118768,-95.55717259229796,194,8,5,5,13
1034,1080,1081,733,472,733,511,222,212,22,188,0,0,0,2,10,476,318,158,153,19,133,0,0,0,1,5,472,266,206,482014335022,,29.67622579725096,-95.55711032971602,187,8,6,7,13
1035,1081,1082,2414,922,2414,1977,437,430,41,166,2,218,0,3,7,1597,1277,320,317,36,115,2,163,0,1,3,922,739,183,482014335023,108200.0,29.68319438152569,-95.55315911411289,200,8,5,7,13
1036,1082,1083,2052,849,2052,1777,275,264,30,190,1,42,0,1,11,1335,1136,199,192,14,143,1,33,0,1,7,849,684,165,482014335024,,29.679484879926168,-95.55418180107016,196,8,5,7,13
1037,1083,1084,1484,910,1484,563,921,907,78,765,2,59,0,3,14,1045,373,672,664,68,537,1,55,0,3,8,910,644,266,482014336001,24500.0,29.668991113587545,-95.55727526505234,195,8,6,8,12
1038,1084,1085,661,328,661,490,171,166,27,118,0,20,0,1,5,442,308,134,132,27,85,0,19,0,1,2,328,235,93,482014336002,,29.66670684373125,-95.55518755488852,205,8,6,10,12
1039,1085,1086,1400,681,1400,397,1003,975,56,708,0,210,0,1,28,976,252,724,704,47,486,0,171,0,0,20,681,529,152,482014336003,,29.673271113042546,-95.55052343537253,193,9,7,9,12
1040,1086,1087,1736,972,1736,600,1136,1124,65,1012,10,33,0,4,12,1158,381,777,768,59,671,6,28,0,4,9,972,658,314,482014336004,,29.671947097344106,-95.55833912015486,181,8,6,7,10
1041,1087,1088,1365,533,1365,1224,141,135,41,65,0,24,4,1,6,1041,922,119,114,37,51,0,22,4,0,5,533,403,130,482014401001,168000.0,29.651578161742744,-95.55944449245564,157,8,6,7,8
1042,1088,1089,2049,748,2049,680,1369,1335,609,559,5,158,0,4,34,1541,463,1078,1052,519,391,5,136,0,1,26,748,723,25,482014401002,120500.0,29.64615405613645,-95.54756270522886,157,7,7,7,7
1043,1090,1091,502,319,502,445,57,54,8,43,1,2,0,0,3,376,337,39,36,8,25,1,2,0,0,3,319,176,143,482014401004,,29.656241205817583,-95.56014956019872,156,8,6,8,7
1044,1091,1092,1756,780,1756,168,1588,1559,1295,22,0,239,2,1,29,1267,110,1157,1145,977,13,0,154,1,0,12,780,730,50,482014501001,159600.0,29.77715906376677,-95.56696887538588,247,6,5,6,18
1045,1092,1093,1827,690,1827,109,1718,1697,1584,8,0,104,1,0,21,1242,63,1179,1173,1084,4,0,84,1,0,6,690,631,59,482014502001,373200.0,29.77894533160279,-95.58595131369805,165,5,6,5,12
1046,1093,1094,1880,647,1880,120,1760,1742,1433,6,7,290,0,6,18,1229,70,1159,1151,975,4,3,167,0,2,8,647,632,15,482014502002,436900.0,29.77827763711953,-95.57878197885984,197,6,6,6,15
1047,1094,1095,1165,470,1165,77,1088,1063,952,35,1,74,0,1,25,846,56,790,775,684,34,1,55,0,1,15,470,435,35,482014502003,278800.0,29.779968467858243,-95.5718944121618,208,6,4,6,16
1048,1095,1096,2362,979,2362,798,1564,1481,779,416,13,267,0,6,83,1635,484,1151,1098,649,242,4,199,0,4,53,979,860,119,482014503001,111400.0,29.77715282912436,-95.6030607968315,168,5,5,5,11
1049,1096,1097,2321,953,2321,665,1656,1619,812,641,8,150,1,7,37,1611,405,1206,1181,687,356,6,127,1,4,25,953,814,139,482014503002,126300.0,29.781681003842824,-95.59657387108896,153,5,4,5,11
1050,1097,1098,663,283,663,71,592,584,500,4,0,80,0,0,8,506,51,455,451,382,3,0,66,0,0,4,283,271,12,482014503003,210100.0,29.77877194680521,-95.59218721334692,159,5,6,5,11
1051,1098,1099,1678,832,1678,445,1233,1163,641,288,3,227,1,3,70,1248,290,958,915,542,197,3,171,1,1,43,832,706,126,482014503004,117700.0,29.77319416680706,-95.59534235333466,186,5,6,5,11
1052,1099,1100,2422,1356,2422,424,1998,1940,1397,248,5,281,2,7,58,1979,303,1676,1639,1200,194,5,233,2,5,37,1356,1224,132,482014504001,202500.0,29.78052691957611,-95.61429029500934,144,5,3,7,10
1053,1100,1101,1001,437,1001,204,797,761,483,203,0,70,0,5,36,730,134,596,573,387,131,0,53,0,2,23,437,364,73,482014504002,117500.0,29.774954423467275,-95.60978710395864,181,5,4,6,10
1054,1101,1102,1080,566,1080,383,697,674,397,160,3,95,0,19,23,809,261,548,534,335,112,3,72,0,12,14,566,453,113,482014504003,109300.0,29.77220950466668,-95.6097817104987,182,5,4,6,10
1055,1102,1103,1299,560,1299,85,1214,1195,1062,16,0,116,0,1,19,1073,56,1017,1000,892,11,0,96,0,1,17,560,541,19,482014505001,297100.0,29.780782178686387,-95.63560142641708,135,4,2,6,8
1056,1103,1104,1642,708,1642,163,1479,1452,1224,42,1,181,0,4,27,1353,119,1234,1215,1028,31,1,151,0,4,19,708,683,25,482014505002,337200.0,29.774451664598843,-95.63361515226794,155,4,2,6,8
1057,1104,1105,909,341,909,57,852,845,815,2,1,27,0,0,7,673,37,636,633,606,2,1,24,0,0,3,341,334,7,482014506001,355000.0,29.764842936218567,-95.61437980605425,176,5,5,7,8
1058,1105,1106,1690,628,1690,516,1174,1145,860,184,3,98,0,0,29,1196,316,880,868,660,127,3,78,0,0,12,628,600,28,482014506002,323200.0,29.76671189574854,-95.60968172374876,183,5,4,6,9
1059,1106,1107,1711,964,1711,265,1446,1401,1088,128,2,173,0,10,45,1381,200,1181,1152,919,81,1,144,0,7,29,964,852,112,482014506003,232100.0,29.77396943811379,-95.61904877970312,174,5,4,7,9
1060,1107,1108,1310,523,1310,119,1191,1163,1073,14,0,76,0,0,28,975,89,886,873,806,10,0,57,0,0,13,523,499,24,482014507001,313900.0,29.7674046943196,-95.60196841931332,183,5,5,6,10
1061,1108,1109,2654,932,2654,121,2533,2503,2337,1,3,160,2,0,30,1860,80,1780,1769,1653,1,3,110,2,0,11,932,906,26,482014507002,399300.0,29.767798286075838,-95.56989607854337,238,6,5,7,15
1062,1109,1110,2497,886,2497,122,2375,2337,2236,5,3,90,0,3,38,1793,79,1714,1697,1621,3,2,68,0,3,17,886,865,21,482014507003,453900.0,29.76581715245444,-95.59110692561993,189,5,6,6,10
1063,1110,1111,788,489,788,97,691,683,548,52,1,82,0,0,8,704,87,617,610,489,45,1,75,0,0,7,489,437,52,482014508011,243400.0,29.76044314275852,-95.56733100543082,256,6,6,7,17
1064,1111,1112,1382,751,1382,389,993,960,542,359,5,52,0,2,33,1146,292,854,837,501,284,5,46,0,1,17,751,720,31,482014508012,350000.0,29.759214943771635,-95.5741082968546,227,6,6,7,15
1065,1112,1113,916,368,916,64,852,839,776,23,0,40,0,0,13,691,38,653,642,595,13,0,34,0,0,11,368,357,11,482014508021,232000.0,29.75367856917817,-95.56520428975624,263,6,6,7,18
1066,1113,1114,1026,798,1026,300,726,710,366,283,2,58,0,1,16,743,201,542,534,308,176,2,48,0,0,8,798,389,409,482014508022,120600.0,29.75152312457425,-95.56810746378508,252,6,6,7,17
1067,1114,1115,1606,900,1606,551,1055,1033,413,590,0,26,0,4,22,1104,352,752,739,323,391,0,22,0,3,13,900,537,363,482014508023,232600.0,29.753550191281704,-95.5718599878358,233,6,6,7,15
1068,1115,1116,733,223,733,571,162,160,68,51,2,39,0,0,2,472,335,137,135,56,40,1,38,0,0,2,223,205,18,482014508024,,29.74991998574639,-95.56062045727528,263,6,6,6,19
1069,1116,1117,1710,1056,1710,516,1194,1144,437,505,1,191,0,10,50,1334,343,991,959,405,376,1,168,0,9,32,1056,775,281,482014508025,233300.0,29.755267894615194,-95.56096883805064,260,6,6,7,18
1070,1117,1118,848,398,848,87,761,750,682,19,2,43,0,4,11,683,63,620,612,558,15,2,33,0,4,8,398,373,25,482014509001,215100.0,29.74194265788237,-95.56232328430812,260,7,5,6,17
1071,1118,1119,1586,800,1586,339,1247,1219,881,165,2,167,2,2,28,1292,244,1048,1028,758,129,2,135,2,2,20,800,741,59,482014509002,203100.0,29.74243721371563,-95.56938865678072,240,7,5,6,16
1072,1119,1120,1548,675,1548,218,1330,1302,1014,94,2,191,0,1,28,1259,153,1106,1092,852,66,2,171,0,1,14,675,651,24,482014510011,206600.0,29.742497256131397,-95.5798488188704,212,6,5,6,13
1073,1120,1121,1749,978,1749,841,908,885,180,647,0,51,0,7,23,1311,565,746,726,166,510,0,49,0,1,20,978,827,151,482014510012,,29.73942340338307,-95.57392938106604,223,7,5,6,14
1074,1121,1122,1684,1007,1684,678,1006,984,310,604,2,59,0,9,22,1266,482,784,770,280,432,2,51,0,5,14,1007,827,180,482014510013,98400.0,29.7449726141314,-95.57430034527044,227,6,6,6,15
1075,1122,1123,1025,660,1025,304,721,694,251,372,3,64,0,4,27,856,227,629,609,234,311,3,59,0,2,20,660,572,88,482014510021,91800.0,29.74273266625272,-95.58709725017236,189,6,5,5,10
1076,1123,1124,1731,677,1731,483,1248,1228,154,1032,3,32,0,7,20,1164,323,841,827,109,686,3,26,0,3,14,677,628,49,482014510022,,29.74571556638375,-95.58558104963606,190,5,6,5,11
1077,1124,1125,1448,709,1448,551,897,872,85,737,2,29,14,5,25,957,355,602,586,76,470,2,24,9,5,16,709,566,143,482014510023,,29.73862943924328,-95.58681888504891,186,6,5,5,10
1078,1125,1126,905,590,905,153,752,732,442,188,2,99,0,1,20,793,125,668,654,413,149,2,89,0,1,14,590,532,58,482014510024,121900.0,29.738868337041183,-95.58319480391448,203,6,5,5,11
1079,1126,1127,578,387,578,53,525,522,438,25,0,56,1,2,3,534,42,492,489,414,22,0,50,1,2,3,387,357,30,482014511001,149600.0,29.761209459668077,-95.5816587667183,215,5,7,7,12
1080,1127,1128,1516,816,1516,437,1079,1046,812,126,4,101,0,3,33,1229,286,943,920,734,96,3,84,0,3,23,816,736,80,482014511002,176300.0,29.75212495993957,-95.58424221032269,204,5,6,6,11
1081,1128,1129,911,405,911,83,828,808,728,19,1,60,0,0,20,752,65,687,677,614,12,1,50,0,0,10,405,384,21,482014511003,271500.0,29.75232672134509,-95.57940018585528,217,6,6,7,14
1082,1129,1130,984,619,984,339,645,634,334,238,1,58,0,3,11,813,249,564,554,313,190,1,47,0,3,10,619,535,84,482014511004,63700.0,29.751171465717643,-95.57456561842858,230,6,6,7,15
1083,1130,1131,1451,588,1451,159,1292,1270,1192,27,0,46,0,5,22,1178,118,1060,1047,985,21,0,39,0,2,13,588,574,14,482014512001,239200.0,29.75758295537539,-95.59928383807564,186,5,5,6,11
1084,1131,1132,1224,539,1224,121,1103,1084,977,32,2,72,0,1,19,1015,97,918,904,825,24,2,52,0,1,14,539,518,21,482014512002,232500.0,29.75286159119987,-95.59019041436216,192,5,6,6,11
1085,1132,1133,1652,732,1652,209,1443,1402,1245,70,15,68,0,4,41,1346,167,1179,1156,1030,54,9,60,0,3,23,732,705,27,482014513001,178200.0,29.746601749539845,-95.5920897044164,187,5,6,5,11
1086,1133,1134,1984,990,1984,445,1539,1484,632,698,6,134,3,11,55,1569,332,1237,1203,550,528,4,110,3,8,34,990,954,36,482014513002,205700.0,29.739124360077792,-95.59361263490926,182,6,5,5,10
1087,1134,1135,2010,957,2010,339,1671,1619,1140,291,6,181,0,1,52,1614,246,1368,1330,962,209,3,155,0,1,38,957,886,71,482014513003,179400.0,29.74156615597076,-95.6014449473613,179,6,4,5,10
1088,1135,1136,1235,560,1235,208,1027,993,847,56,3,80,2,5,34,974,157,817,799,691,40,3,63,2,0,18,560,525,35,482014513004,148000.0,29.749705723964823,-95.60101109679964,184,5,5,5,11
1089,1136,1137,1543,907,1543,262,1281,1265,898,159,7,194,0,7,16,1279,189,1090,1081,787,120,7,162,0,5,9,907,809,98,482014514011,162800.0,29.75107282391261,-95.6147789733516,174,5,4,7,9
1090,1137,1138,1787,911,1787,456,1331,1307,765,407,0,126,0,9,24,1398,321,1077,1061,644,307,0,105,0,5,16,911,870,41,482014514012,160800.0,29.749642518491324,-95.6098675660017,183,5,4,5,10
1091,1138,1139,3108,1664,3108,801,2307,2251,1013,1038,7,165,3,25,56,2394,548,1846,1811,895,750,6,144,3,13,35,1664,1543,121,482014514021,95500.0,29.741801975907787,-95.61119878655803,177,6,3,5,10
1092,1139,1140,1435,922,1435,583,852,819,342,407,0,64,0,6,33,1161,444,717,692,309,327,0,54,0,2,25,922,781,141,482014514022,219200.0,29.739211376170505,-95.61635839036396,168,6,3,6,9
1093,1140,1141,2488,1712,2488,614,1874,1805,827,649,7,313,1,8,69,1994,454,1540,1492,711,522,5,250,1,3,48,1712,1316,396,482014514031,396200.0,29.750542848030666,-95.6219281568314,169,4,4,7,8
1094,1141,1142,1016,578,1016,159,857,839,514,159,4,160,0,2,18,854,128,726,716,447,135,2,132,0,0,10,578,537,41,482014514032,198600.0,29.74124272162837,-95.6211566366814,165,5,3,6,8
1095,1142,1143,3528,2303,3528,510,3018,2958,1816,404,7,730,0,1,60,3043,417,2626,2579,1655,334,5,584,0,1,47,2303,2009,294,482014515001,165900.0,29.76080654704152,-95.6187622585296,172,5,5,7,8
1096,1143,1144,1556,973,1556,401,1155,1114,520,384,3,198,1,8,41,1311,320,991,960,477,317,2,157,1,6,31,973,913,60,482014515002,167100.0,29.756328338436813,-95.6096745772627,184,5,4,6,10
1097,1144,1145,2076,891,2076,237,1839,1792,1437,56,2,287,0,10,47,1642,174,1468,1440,1173,36,1,225,0,5,28,891,856,35,482014516011,249400.0,29.768725427984787,-95.63055983457215,164,4,2,8,8
1098,1145,1146,3810,1879,3810,450,3360,3295,2319,196,2,770,1,7,65,3021,305,2716,2686,2007,142,2,528,1,6,30,1879,1715,164,482014516012,292000.0,29.760831192711947,-95.63571305093966,154,4,3,6,7
1099,1146,1147,3176,1281,3176,683,2493,2402,1580,250,9,551,5,7,91,2367,469,1898,1850,1237,195,7,401,5,5,48,1281,1212,69,482014516021,182700.0,29.74630488282981,-95.63963691058036,154,4,2,6,9
1100,1147,1148,4141,1945,4141,671,3470,3354,1821,437,12,1069,0,15,116,3182,491,2691,2620,1460,329,7,810,0,14,71,1945,1753,192,482014516022,558600.0,29.74508787148014,-95.62985108058714,162,4,2,7,8
1101,1148,1149,2195,1206,2195,459,1736,1698,478,1056,4,155,0,5,38,1674,315,1359,1336,450,752,3,129,0,2,23,1206,1028,178,482014517001,110800.0,29.732487946048725,-95.63760802417195,155,4,2,6,9
1102,1150,1151,818,272,818,354,464,437,177,139,10,108,0,3,27,597,239,358,344,151,90,6,94,0,3,14,272,254,18,482014518001,128100.0,29.72386959053693,-95.62131735165828,162,6,3,6,8
1103,1152,1153,1330,619,1330,574,756,732,268,274,0,189,1,0,24,968,387,581,567,218,178,0,170,1,0,14,619,422,197,482014518003,115500.0,29.71643302481146,-95.6199079606478,161,7,3,6,9
1104,1153,1154,657,281,657,182,475,466,96,335,0,33,2,0,9,468,119,349,342,88,224,0,29,1,0,7,281,267,14,482014519011,91100.0,29.720000489505637,-95.61521562768291,164,7,3,6,9
1105,1154,1155,2131,765,2131,722,1409,1371,612,359,1,390,0,9,38,1640,517,1123,1099,516,247,1,328,0,7,24,765,712,53,482014519012,132800.0,29.725809495592387,-95.61256016726156,172,7,3,6,10
1106,1155,1156,2013,1069,2013,609,1404,1375,248,936,4,185,0,2,29,1552,434,1118,1095,229,711,2,153,0,0,23,1069,913,156,482014519013,123800.0,29.720774960397147,-95.60847043866706,172,7,3,6,10
1107,1156,1157,2610,1420,2610,900,1710,1678,180,1451,1,44,0,2,32,1875,583,1292,1269,164,1062,1,40,0,2,23,1420,1229,191,482014519014,,29.7159962380974,-95.61012068909112,174,7,3,5,10
1108,1157,1158,2466,891,2466,283,2183,2139,841,175,0,1119,0,4,44,1885,209,1676,1647,659,120,0,864,0,4,29,891,854,37,482014519021,249400.0,29.722458264838785,-95.59870481112348,175,7,4,5,10
1109,1158,1159,1975,1036,1975,524,1451,1388,645,484,3,249,0,7,63,1605,392,1213,1170,576,377,3,209,0,5,43,1036,850,186,482014520001,135200.0,29.73247848180149,-95.61508629167724,167,6,3,6,9
1110,1159,1160,1156,574,1156,279,877,838,228,461,5,138,1,5,39,850,198,652,628,194,312,2,118,1,1,24,574,450,124,482014520002,149600.0,29.731050602247347,-95.60910935733013,178,6,3,5,10
1111,1160,1161,4005,2113,4005,1037,2968,2850,859,1451,9,526,1,4,118,3175,777,2398,2316,752,1131,4,424,1,4,82,2113,1948,165,482014520003,,29.73326662773324,-95.60009009541568,177,6,4,5,10
1112,1161,1162,1933,990,1933,470,1463,1417,324,854,8,230,0,1,46,1481,329,1152,1126,305,619,7,194,0,1,26,990,860,130,482014521001,,29.731555403641003,-95.5754531786268,218,7,5,6,14
1113,1162,1163,5290,2909,5290,983,4307,4199,2269,1165,5,745,0,15,108,4373,736,3637,3558,1986,940,3,614,0,15,79,2909,2646,263,482014521002,840200.0,29.724962608426484,-95.58348446245414,202,7,5,5,11
1114,1163,1164,1600,1020,1600,346,1254,1214,432,576,7,195,0,4,40,1390,285,1105,1072,402,484,6,176,0,4,33,1020,938,82,482014521003,,29.734732005931964,-95.5783151250167,210,7,5,6,13
1115,1164,1165,1252,752,1252,423,829,793,258,437,0,96,0,2,36,968,280,688,664,235,343,0,84,0,2,24,752,649,103,482014522011,,29.733609876345525,-95.56056335193834,257,7,5,6,18
1116,1165,1166,758,479,758,221,537,517,132,312,0,71,0,2,20,612,154,458,446,126,258,0,61,0,1,12,479,426,53,482014522012,68300.0,29.730411341401805,-95.56983450211752,232,7,5,6,14
1117,1166,1167,1575,958,1575,559,1016,966,262,592,5,102,4,1,50,1292,436,856,824,237,489,5,91,2,0,32,958,848,110,482014522013,46200.0,29.729561246873025,-95.5636071164508,251,7,5,6,16
1118,1167,1168,1630,1003,1630,600,1030,1006,203,661,5,134,0,3,24,1319,451,868,848,192,536,3,114,0,3,20,1003,895,108,482014522014,,29.734543164443373,-95.56754931589988,248,7,5,6,16
1119,1168,1169,730,485,730,94,636,624,256,236,0,129,0,3,12,649,78,571,560,241,201,0,115,0,3,11,485,458,27,482014522021,,29.72268213056181,-95.5616643174882,251,8,5,6,16
1120,1169,1170,2233,1240,2233,754,1479,1431,393,729,6,293,2,8,48,1780,567,1213,1182,359,564,5,246,2,6,31,1240,1066,174,482014522022,82600.0,29.722563791547543,-95.56861365467226,234,8,5,6,14
1121,1170,1171,2323,730,2323,1052,1271,1239,157,394,1,680,0,7,32,1719,693,1026,1001,138,279,1,577,0,6,25,730,685,45,482014523001,105000.0,29.710862448134392,-95.56435592391294,227,7,5,5,13
1122,1171,1172,2950,951,2950,1342,1608,1579,293,622,2,659,1,2,29,2143,927,1216,1199,267,401,1,529,1,0,17,951,903,48,482014524001,96200.0,29.71353282564673,-95.58193458159204,202,6,5,6,11
1123,1172,1173,2242,676,2242,1030,1212,1176,175,207,1,783,0,10,36,1608,681,927,913,167,142,1,596,0,7,14,676,658,18,482014524002,98500.0,29.70922009320797,-95.57959741821976,175,7,5,5,11
1124,1173,1174,961,343,961,376,585,580,96,431,0,52,0,1,5,624,235,389,384,77,264,0,43,0,0,5,343,295,48,482014524003,115100.0,29.70628859800816,-95.58320599045489,160,6,4,3,8
1125,1174,1175,2039,679,2039,1011,1028,1013,149,275,0,587,0,2,15,1465,664,801,789,130,166,0,491,0,2,12,679,647,32,482014524004,108300.0,29.710856001116525,-95.57403400959888,195,7,5,5,11
1126,1175,1176,2578,990,2578,722,1856,1812,137,1326,12,332,1,4,44,1655,461,1194,1173,122,779,8,263,1,0,21,990,866,124,482014525001,88900.0,29.705306824202232,-95.6096489519477,134,6,3,2,7
1127,1176,1177,2415,832,2415,1233,1182,1173,200,336,2,635,0,0,9,1619,751,868,863,173,224,2,464,0,0,5,832,718,114,482014525002,89800.0,29.709267284346293,-95.59614274996191,147,6,4,4,8
1128,1177,1178,2801,859,2801,1234,1567,1534,268,423,5,834,0,4,33,1981,819,1162,1145,232,264,4,641,0,4,17,859,806,53,482014525003,94800.0,29.710480451247808,-95.60955083415944,147,6,3,3,8
1129,1178,1179,0,0,0,0,0,0,0,0,0,0,0,0,0,0,0,0,0,0,0,0,0,0,0,0,0,0,0,482014526001,,29.708592381962248,-95.64240296552188,102,4,2,3,6
1130,1179,1180,681,204,681,272,409,399,141,151,0,107,0,0,10,515,183,332,325,122,116,0,87,0,0,7,204,194,10,482014526002,112200.0,29.70849701134205,-95.61754013736488,132,6,3,3,7
1131,1181,1182,1047,314,1047,567,480,446,63,216,4,155,0,8,34,752,381,371,350,56,156,2,133,0,3,21,314,299,15,482014527001,97800.0,29.70100146404077,-95.61725373428332,126,6,3,2,7
1132,1182,1183,621,179,621,288,333,331,37,132,1,160,0,1,2,437,193,244,244,29,83,1,130,0,1,0,179,170,9,482014527002,132800.0,29.69542398489576,-95.61758863102136,114,6,4,2,6
1133,1183,1184,97,40,97,12,85,84,4,35,0,41,4,0,1,75,8,67,66,4,25,0,34,3,0,1,40,32,8,482014527004,,29.69630808281187,-95.64099469425808,84,4,2,2,5
1134,1184,1185,2276,847,2276,622,1654,1614,285,592,4,728,1,4,40,1729,438,1291,1260,261,399,4,591,1,4,31,847,780,67,482014528011,98100.0,29.699554935222032,-95.61057990136808,132,6,3,2,7
1135,1185,1186,1303,373,1303,422,881,849,183,454,0,212,0,0,32,923,260,663,650,153,325,0,172,0,0,13,373,346,27,482014528012,121300.0,29.69326612004767,-95.60863940018326,124,6,4,3,6
1136,1186,1187,1170,429,1170,505,665,640,83,383,0,173,0,1,25,809,323,486,472,77,258,0,136,0,1,14,429,389,40,482014528013,83500.0,29.70073527542889,-95.60577576062433,136,6,3,3,7
1137,1187,1188,3239,1086,3239,1737,1502,1468,99,832,7,520,1,9,34,2086,1071,1015,997,86,487,4,415,1,4,18,1086,953,133,482014528021,74900.0,29.692618815812697,-95.60016076704215,129,6,5,3,6
1138,1188,1189,2710,847,2710,1186,1524,1492,127,660,2,702,0,1,32,1860,742,1118,1098,108,423,2,565,0,0,20,847,800,47,482014528022,99200.0,29.69986541668188,-95.60025169374636,138,6,4,3,7
1139,1189,1190,1871,650,1871,994,877,860,182,234,0,444,0,0,17,1327,648,679,666,164,158,0,344,0,0,13,650,585,65,482014529001,58800.0,29.69991186896299,-95.5919251949053,140,6,4,3,7
1140,1190,1191,2169,613,2169,1201,968,948,256,384,5,292,1,10,20,1499,773,726,715,221,236,4,247,1,6,11,613,565,48,482014529002,108600.0,29.692552383337212,-95.59178402134842,131,6,5,3,6
1141,1191,1192,2701,723,2701,1873,828,813,219,231,3,352,0,8,15,1873,1245,628,617,181,138,2,292,0,4,11,723,688,35,482014530001,113400.0,29.69237581934845,-95.5811185366312,157,7,5,4,8
1142,1192,1193,2536,685,2536,1642,894,873,252,157,4,449,1,10,21,1809,1064,745,729,238,109,2,372,1,7,16,685,662,23,482014530002,106700.0,29.70000253835473,-95.5814922827228,164,6,4,4,9
1143,1193,1194,2620,795,2620,1757,863,836,128,414,0,291,0,3,27,1705,1078,627,606,118,236,0,250,0,2,21,795,683,112,482014530003,82000.0,29.696103637716963,-95.57306270625502,167,7,4,4,9
1144,1194,1195,2046,1124,2046,1271,775,757,83,530,2,135,1,6,18,1354,800,554,543,74,353,1,112,1,2,11,1124,651,473,482014531001,95200.0,29.69270741816561,-95.5644137644664,198,8,5,4,11
1145,1195,1196,1220,534,1220,474,746,725,130,223,3,362,3,4,21,939,309,630,614,116,174,2,316,2,4,16,534,497,37,482014531002,74900.0,29.70014709495713,-95.56402020232044,207,7,4,4,13
1146,1196,1197,2515,888,2515,1210,1305,1276,323,567,10,360,5,11,29,1854,800,1054,1037,290,449,10,281,4,3,17,888,829,59,482014532001,98400.0,29.679649104127897,-95.56490546207432,177,8,5,4,10
1147,1197,1198,2572,861,2572,1651,921,895,63,497,4,330,0,1,26,1602,960,642,627,40,318,4,264,0,1,15,861,752,109,482014532002,32000.0,29.687669238137293,-95.56681077325538,187,8,5,4,11
1148,1198,1199,2860,1113,2860,1481,1379,1337,120,1030,6,177,1,3,42,1926,925,1001,967,99,706,4,154,1,3,34,1113,1039,74,482014532003,,29.686783685759387,-95.56204397921222,193,8,5,4,12
1149,1199,1200,2965,1299,2965,621,2344,2289,114,1506,3,652,1,13,55,2034,396,1638,1599,106,949,3,532,1,8,39,1299,1139,160,482014533001,24700.0,29.66417295371095,-95.56511064677254,168,8,6,8,7
1150,1200,1201,1684,640,1684,990,694,673,177,299,3,191,3,0,21,1174,637,537,522,154,206,3,156,3,0,15,640,587,53,482014534011,95700.0,29.656990636768903,-95.57937491247206,138,8,7,8,5
1151,1201,1202,1441,447,1441,828,613,602,284,163,13,140,0,2,11,1067,551,516,511,257,128,8,116,0,2,5,447,434,13,482014534012,112500.0,29.65323947802858,-95.57461961750968,146,8,6,7,6
1152,1202,1203,990,290,990,477,513,483,69,180,2,230,0,2,30,707,311,396,376,58,118,2,196,0,2,20,290,281,9,482014534021,105800.0,29.659388276972045,-95.57572738882926,148,8,6,8,6
1153,1203,1204,1976,672,1976,1112,864,851,123,472,3,250,0,3,13,1361,729,632,621,103,319,3,194,0,2,11,672,625,47,482014534022,86700.0,29.670985877126967,-95.57341307500882,151,8,6,7,8
1154,1204,1205,3249,1072,3249,1683,1566,1540,284,654,5,586,3,8,26,2256,1059,1197,1180,260,460,4,452,2,2,17,1072,978,94,482014534023,102900.0,29.667222228961883,-95.58070107895657,160,7,6,7,9
1155,1205,1206,1999,772,1999,949,1050,995,101,454,7,430,0,3,55,1352,589,763,721,92,301,2,324,0,2,42,772,662,110,482014534024,124000.0,29.664146327661356,-95.57368587759058,157,8,6,8,7
1156,1206,1207,1313,550,1313,426,887,879,68,458,0,351,0,2,8,932,264,668,663,60,324,0,277,0,2,5,550,407,143,482014534031,100700.0,29.66744043867551,-95.5863577763227,144,7,6,6,6
1157,1207,1208,1820,1036,1820,745,1075,1068,63,813,7,179,0,6,7,1261,473,788,782,50,559,6,162,0,5,6,1036,699,337,482014534032,,29.67173393999857,-95.58410690274845,131,7,6,6,5
1158,1208,1209,1940,556,1940,775,1165,1140,101,415,1,622,0,1,25,1423,509,914,899,89,286,1,522,0,1,15,556,530,26,482014535011,100100.0,29.66470997563456,-95.5895037075593,138,7,6,7,4
1159,1209,1210,2447,834,2447,958,1489,1427,274,624,9,505,0,15,62,1714,598,1116,1072,239,408,3,414,0,8,44,834,776,58,482014535012,109200.0,29.66017632189836,-95.59030789538971,126,7,6,8,4
1160,1210,1211,1787,760,1787,685,1102,1057,109,607,0,337,1,3,45,1208,425,783,759,72,409,0,276,1,1,24,760,625,135,482014535013,99400.0,29.672349632221422,-95.5899652538825,120,7,6,6,5
1161,1211,1212,1962,574,1962,813,1149,1128,241,641,1,239,1,5,21,1370,518,852,841,210,425,1,201,1,3,11,574,542,32,482014535021,110200.0,29.66928176049917,-95.59576000235668,126,6,6,6,6
1162,1212,1213,1723,561,1723,783,940,918,207,527,4,177,0,3,22,1172,502,670,662,189,328,1,142,0,2,8,561,510,51,482014535022,92000.0,29.672791731930097,-95.60039234406403,115,6,6,6,5
1163,1213,1214,2108,744,2108,936,1172,1139,159,703,2,267,0,8,33,1401,591,810,791,144,424,1,215,0,7,19,744,632,112,482014536011,105200.0,29.68223889763516,-95.59158508191094,114,6,5,3,6
1164,1214,1215,1615,467,1615,839,776,755,153,171,1,429,1,0,21,1170,551,619,604,141,113,1,349,0,0,15,467,434,33,482014536021,106900.0,29.685862520136368,-95.5805787760077,147,7,5,4,10
1165,1215,1216,1798,709,1798,510,1288,1258,218,846,2,192,0,0,30,1297,311,986,966,214,586,2,164,0,0,20,709,650,59,482014536022,79700.0,29.681555301868887,-95.57230668776155,152,8,5,4,9
1166,1216,1217,2389,777,2389,1338,1051,1019,108,574,0,331,1,5,32,1644,874,770,752,91,388,0,270,1,2,18,777,653,124,482014536023,94800.0,29.67762948988093,-95.58028886446516,137,7,5,5,9
1167,1217,1218,1897,525,1897,1235,662,650,104,255,1,287,0,3,12,1313,798,515,509,94,175,1,237,0,2,6,525,498,27,482014536024,102800.0,29.68208366334349,-95.58305919631891,136,7,5,3,7
1168,1218,1219,354,81,354,143,211,199,63,113,0,23,0,0,12,292,99,193,181,62,100,0,19,0,0,12,81,79,2,482014537001,114200.0,29.686293739328512,-95.6067095673296,115,6,4,3,7
1169,1219,1220,1069,330,1069,447,622,612,106,391,5,110,0,0,10,733,308,425,419,90,240,4,85,0,0,6,330,296,34,482014537002,99300.0,29.681571851655423,-95.60559778161304,107,6,4,3,6
1170,1220,1221,1613,725,1613,592,1021,1010,152,690,0,163,0,5,11,1126,365,761,758,137,482,0,137,0,2,3,725,579,146,482014537003,80500.0,29.68458392418911,-95.60103193596656,116,6,5,3,6
1171,1221,1222,2181,803,2181,807,1374,1348,146,975,3,222,1,1,26,1506,525,981,958,134,638,3,181,1,1,23,803,703,100,482014537004,84000.0,29.6816014633025,-95.5978808603827,111,6,5,3,6
1172,1222,1223,1700,585,1700,647,1053,1017,232,573,2,209,1,0,36,1215,410,805,786,214,382,2,187,1,0,19,585,532,53,482014538001,128000.0,29.67334061054128,-95.60957840298316,110,6,5,5,6
1173,1223,1224,1642,511,1642,767,875,868,318,339,3,205,0,3,7,1174,490,684,679,278,227,3,171,0,0,5,511,492,19,482014538002,111100.0,29.66649278545004,-95.60378871895672,138,6,6,6,6
1174,1224,1225,0,0,0,0,0,0,0,0,0,0,0,0,0,0,0,0,0,0,0,0,0,0,0,0,0,0,0,482014539001,150800.0,29.68906859634616,-95.64191412578025,84,4,3,2,6
1175,1225,1226,33,9,33,14,19,19,7,12,0,0,0,0,0,24,8,16,16,7,9,0,0,0,0,0,9,8,1,482014540001,121000.0,29.69944223467982,-95.6584603084034,73,1,2,2,4
1176,1227,1228,10,3,10,2,8,8,0,0,0,8,0,0,0,9,2,7,7,0,0,0,7,0,0,0,3,3,0,482014541001,144700.0,29.70576488275103,-95.64647272997914,92,2,2,3,4
1177,1228,1229,0,0,0,0,0,0,0,0,0,0,0,0,0,0,0,0,0,0,0,0,0,0,0,0,0,0,0,482014541002,132500.0,29.700067314246585,-95.65822729206232,74,1,2,2,4
1178,1229,1230,23,12,23,9,14,14,6,5,0,3,0,0,0,19,6,13,13,6,4,0,3,0,0,0,12,9,3,482014542001,105700.0,29.70012061075514,-95.6670562782772,65,1,2,1,4
1179,1230,1231,0,0,0,0,0,0,0,0,0,0,0,0,0,0,0,0,0,0,0,0,0,0,0,0,0,0,0,482014543011,106100.0,29.717310847476657,-95.65740371588632,127,2,2,6,5
1180,1233,1234,1395,937,1395,401,994,950,189,616,3,133,0,9,44,1027,279,748,727,151,462,1,106,0,7,21,937,611,326,482014543014,183500.0,29.72426635683548,-95.64727973323036,135,2,2,6,7
1181,1234,1235,22,10,22,4,18,16,6,2,0,8,0,0,2,19,3,16,14,6,2,0,6,0,0,2,10,10,0,482014543021,113500.0,29.71750444621909,-95.66845959809596,137,3,2,5,6
1182,1236,1237,52,32,52,5,47,47,27,15,1,2,0,2,0,40,3,37,37,21,11,1,2,0,2,0,32,26,6,482014544001,,29.749199191336896,-95.67229835938087,150,3,1,5,7
1183,1237,1238,5,2,5,0,5,5,5,0,0,0,0,0,0,5,0,5,5,5,0,0,0,0,0,0,2,2,0,482014545011,292500.0,29.77414230631805,-95.71844905336305,131,3,3,5,8
1184,1238,1239,0,0,0,0,0,0,0,0,0,0,0,0,0,0,0,0,0,0,0,0,0,0,0,0,0,0,0,482014545012,221600.0,29.78085229117073,-95.7107508833004,130,4,3,5,8
1185,1240,1241,214,69,214,51,163,161,89,10,0,59,1,2,2,141,29,112,112,61,10,0,39,1,1,0,69,69,0,482014545021,309900.0,29.739306631015324,-95.71425624092193,124,3,2,6,6
1186,1241,1242,2289,1223,2289,654,1635,1576,1149,246,5,169,2,5,59,1779,466,1313,1293,979,183,4,122,1,4,20,1223,1144,79,482014546001,178900.0,29.780874577559548,-95.7404469228134,133,2,4,5,8
1187,1242,1243,61,19,61,15,46,44,37,7,0,0,0,0,2,40,10,30,28,25,3,0,0,0,0,2,19,18,1,482014547002,312100.0,29.770567060956505,-95.71857377311194,131,3,3,5,8
1188,1243,1244,0,0,0,0,0,0,0,0,0,0,0,0,0,0,0,0,0,0,0,0,0,0,0,0,0,0,0,482014548001,120000.0,29.759886545520946,-95.7500880721482,136,2,3,5,8
1189,1244,1245,0,0,0,0,0,0,0,0,0,0,0,0,0,0,0,0,0,0,0,0,0,0,0,0,0,0,0,482014548002,127000.0,29.76713285285068,-95.75027040673469,133,2,3,5,8
1190,1245,1246,1080,651,1080,238,842,814,575,145,10,75,2,7,28,886,180,706,690,503,110,5,63,2,7,16,651,626,25,482014548003,128200.0,29.773836861918983,-95.7440817922804,132,2,3,5,8
1191,1247,1248,19,9,19,6,13,12,9,0,0,3,0,0,1,16,5,11,10,8,0,0,2,0,0,1,9,8,1,482014551012,99400.0,29.766901638531085,-95.75232394008472,134,2,3,5,8
1192,1248,1249,0,0,0,0,0,0,0,0,0,0,0,0,0,0,0,0,0,0,0,0,0,0,0,0,0,0,0,482014551022,125000.0,29.77273360865482,-95.77553283627245,140,2,3,5,8
1193,1249,1250,27,11,27,13,14,14,11,1,0,2,0,0,0,22,9,13,13,10,1,0,2,0,0,0,11,11,0,482014552001,123200.0,29.7812820926143,-95.75435744213466,132,2,3,5,8
1194,1250,1251,15,4,15,6,9,9,9,0,0,0,0,0,0,14,5,9,9,9,0,0,0,0,0,0,4,4,0,482014552002,115100.0,29.784409529270658,-95.7626078403542,143,2,3,5,8
1195,1251,1252,12,2,12,9,3,3,2,1,0,0,0,0,0,8,6,2,2,2,0,0,0,0,0,0,2,2,0,482014552003,166600.0,29.78142125573971,-95.77353756740622,138,2,3,5,8
1196,1252,1253,699,250,699,210,489,478,246,212,2,17,1,0,11,475,124,351,345,202,126,2,14,1,0,6,250,234,16,482014553001,206900.0,29.77885017873967,-95.78053973414774,137,2,3,4,8
1197,1253,1254,1311,606,1311,466,845,840,552,240,3,43,0,2,5,1191,382,809,804,525,233,3,42,0,1,5,606,532,74,482015101001,120500.0,29.767771688374395,-95.37126950279335,549,14,26,23,23
1198,1254,1255,831,443,831,503,328,320,210,82,6,19,0,3,8,690,388,302,294,195,73,6,17,0,3,8,443,350,93,482015101002,170800.0,29.77487753355071,-95.37149850004782,543,13,24,20,23
1199,1255,1256,1189,505,1189,626,563,537,387,130,2,16,0,2,26,977,467,510,494,355,120,2,15,0,2,16,505,455,50,482015102001,259100.0,29.772708167005437,-95.37926637389164,572,15,23,22,24
1200,1256,1257,4243,2802,4243,886,3357,3282,2697,243,16,312,8,6,75,3926,759,3167,3108,2588,211,14,284,5,6,59,2802,2612,190,482015102002,279500.0,29.76868750247844,-95.38905800961788,603,16,25,22,28
1201,1257,1258,1333,676,1333,379,954,932,828,46,4,47,0,7,22,1082,285,797,785,693,43,4,39,0,6,12,676,587,89,482015103001,349400.0,29.784084622147542,-95.37234310044607,524,13,23,16,23
1202,1258,1259,1343,796,1343,369,974,948,859,52,3,31,1,2,26,1141,281,860,844,768,44,3,28,1,0,16,796,714,82,482015103002,206400.0,29.78072342196755,-95.38044180224014,572,13,23,18,25
1203,1259,1260,929,480,929,183,746,730,702,10,5,11,0,2,16,748,142,606,597,576,9,4,8,0,0,9,480,437,43,482015103003,341200.0,29.78623782716626,-95.3804473446049,565,13,22,12,24
1204,1260,1261,944,502,944,297,647,625,597,8,2,17,1,0,22,763,214,549,535,510,8,2,14,1,0,14,502,454,48,482015103004,266000.0,29.789383974686658,-95.3815870847772,561,14,21,10,24
1205,1261,1262,735,424,735,118,617,611,588,7,1,13,1,1,6,627,96,531,528,506,6,1,13,1,1,3,424,393,31,482015103005,262500.0,29.784447278654216,-95.3859876388486,579,14,22,16,28
1206,1262,1263,1517,881,1517,407,1110,1082,1012,34,1,31,0,4,28,1268,315,953,937,877,32,1,25,0,2,16,881,790,91,482015104001,325000.0,29.786126510385795,-95.39476361403264,595,13,20,12,27
1207,1263,1264,1034,544,1034,277,757,732,695,15,3,17,0,2,25,853,219,634,623,592,13,3,15,0,0,11,544,493,51,482015104002,270600.0,29.786208719797703,-95.38984196701772,587,13,21,12,27
1208,1264,1265,1286,804,1286,318,968,945,869,43,1,29,0,3,23,1140,258,882,864,794,37,1,29,0,3,18,804,734,70,482015104003,325000.0,29.779199237851877,-95.3924454859266,602,12,21,22,29
1209,1265,1266,1145,652,1145,425,720,700,640,34,0,24,0,2,20,943,301,642,625,569,30,0,24,0,2,17,652,552,100,482015105001,258600.0,29.787885243908576,-95.40103651126456,605,10,20,9,28
1210,1266,1267,682,370,682,257,425,409,326,59,1,20,0,3,16,566,194,372,365,290,54,1,18,0,2,7,370,305,65,482015105002,241100.0,29.78071194191649,-95.40295506058628,617,10,21,19,29
1211,1267,1268,1022,501,1022,349,673,660,449,172,2,32,0,5,13,821,238,583,575,395,145,2,28,0,5,8,501,440,61,482015105003,216000.0,29.78695580527724,-95.40710182013336,625,10,20,9,29
1212,1268,1269,1123,551,1123,413,710,701,574,39,1,82,1,4,9,947,318,629,624,516,30,1,73,1,3,5,551,496,55,482015106001,279500.0,29.77453861036806,-95.4234858980292,685,11,20,24,35
1213,1269,1270,2092,1171,2092,906,1186,1155,814,205,4,128,1,3,31,1807,706,1101,1071,777,172,4,116,1,1,30,1171,1040,131,482015106002,208500.0,29.773598561354085,-95.40349490887596,643,13,22,23,31
1214,1270,1271,1548,799,1548,540,1008,992,816,59,2,109,0,6,16,1358,431,927,914,758,51,2,97,0,6,13,799,712,87,482015106003,287000.0,29.774242506659803,-95.41519542867728,664,12,21,24,34
1215,1271,1272,1441,833,1441,318,1123,1091,888,53,8,139,0,3,32,1262,264,998,976,801,45,8,119,0,3,22,833,746,87,482015107001,338500.0,29.76797355291812,-95.4020998815854,634,13,24,24,30
1216,1272,1273,2070,1453,2070,402,1668,1630,1364,83,4,173,0,6,38,1952,352,1600,1566,1321,74,4,162,0,5,34,1453,1362,91,482015107002,326100.0,29.764666180690817,-95.40494165684416,642,13,24,26,34
1217,1273,1274,947,494,947,146,801,786,635,59,5,86,0,1,15,842,119,723,715,588,48,2,77,0,0,8,494,477,17,482015108001,325200.0,29.768156749084195,-95.4124205378967,657,13,24,24,32
1218,1274,1275,1553,1099,1553,154,1399,1388,1226,65,1,92,0,4,11,1469,142,1327,1319,1175,55,1,85,0,3,8,1099,956,143,482015108002,442800.0,29.76159839731545,-95.41839451316488,692,13,24,27,38
1219,1275,1276,1140,675,1140,184,956,946,817,38,0,87,1,3,10,1020,144,876,870,756,34,0,76,1,3,6,675,641,34,482015108003,347400.0,29.763608433462828,-95.41932061871508,683,12,24,27,38
1220,1276,1277,819,449,819,101,718,702,658,13,3,27,0,1,16,722,75,647,639,602,11,3,22,0,1,8,449,418,31,482015108004,386200.0,29.768020684226737,-95.44182897823691,660,11,24,26,36
1221,1277,1278,1265,744,1265,255,1010,981,816,70,2,93,0,0,29,1107,215,892,868,722,67,2,77,0,0,24,744,701,43,482015108005,737900.0,29.76691459319374,-95.4241965523842,674,12,23,26,36
1222,1278,1279,1184,662,1184,188,996,979,880,15,2,81,0,1,17,1046,152,894,883,800,13,1,69,0,0,11,662,617,45,482015108006,344600.0,29.768409856418945,-95.41822752675051,674,13,24,25,35
1223,1279,1280,2119,1000,2119,933,1186,1176,1026,52,3,80,0,15,10,1704,659,1045,1038,912,46,3,67,0,10,7,1000,928,72,482015109001,261300.0,29.78677110766009,-95.42367753516554,659,8,19,10,33
1224,1280,1281,2620,1326,2620,1147,1473,1422,1118,104,9,188,0,3,51,2193,834,1359,1327,1052,94,9,172,0,0,32,1326,1212,114,482015109002,252200.0,29.78323775971504,-95.4384936760572,652,8,20,16,35
1225,1281,1282,1331,595,1331,750,581,562,434,32,4,91,0,1,19,1082,559,523,511,397,26,4,83,0,1,12,595,539,56,482015109003,145600.0,29.78036971535024,-95.41441229059572,640,10,21,21,32
1226,1282,1283,1484,856,1484,244,1240,1203,1091,56,4,51,0,1,37,1307,198,1109,1079,970,54,4,50,0,1,30,856,800,56,482015110011,245800.0,29.80419125042035,-95.44008795330728,592,8,13,5,29
1227,1283,1284,1201,642,1201,350,851,843,745,61,8,25,0,4,8,1008,258,750,745,660,53,5,23,0,4,5,642,604,38,482015110012,226000.0,29.79582103049803,-95.44340479463344,613,7,12,8,32
1228,1284,1285,1814,1025,1814,520,1294,1275,1122,93,3,52,0,5,19,1535,398,1137,1126,988,84,3,46,0,5,11,1025,957,68,482015110021,293000.0,29.794739282126937,-95.42586937603129,630,9,14,9,32
1229,1285,1286,1474,935,1474,636,838,815,581,180,6,47,0,1,23,1227,483,744,729,529,152,6,42,0,0,15,935,846,89,482015110022,,29.79900545785712,-95.43572924017718,615,7,13,6,30
1230,1286,1287,973,489,973,124,849,839,772,14,8,42,1,2,10,840,99,741,735,685,12,6,30,1,1,6,489,473,16,482015110023,267400.0,29.79428872515116,-95.43341000787416,629,9,15,9,32
1231,1287,1288,1177,722,1177,377,800,787,542,201,4,38,1,1,13,1023,281,742,736,512,185,4,33,1,1,6,722,558,164,482015111001,208300.0,29.80814819230532,-95.43326925861192,556,7,12,5,24
1232,1288,1289,1499,826,1499,535,964,939,797,75,2,63,0,2,25,1281,409,872,859,730,66,2,59,0,2,13,826,704,122,482015111002,275900.0,29.808581275572195,-95.4227764882276,559,7,11,5,24
1233,1289,1290,871,473,871,219,652,642,537,65,3,35,0,2,10,764,167,597,587,492,58,3,32,0,2,10,473,426,47,482015112001,241400.0,29.80726647268565,-95.41738088128652,559,8,12,5,23
1234,1290,1291,1989,929,1989,833,1156,1130,946,121,5,55,1,2,26,1641,599,1042,1025,861,108,4,50,1,1,17,929,851,78,482015112002,242100.0,29.79892702360469,-95.41465824261488,602,9,12,6,28
1235,1291,1292,1564,891,1564,367,1197,1175,1050,56,1,67,0,1,22,1362,289,1073,1058,948,53,1,55,0,1,15,891,821,70,482015112003,237200.0,29.79797614291361,-95.41994843103436,619,8,12,6,29
1236,1292,1293,1206,697,1206,365,841,823,779,25,1,14,2,2,18,996,261,735,723,687,23,1,10,2,0,12,697,659,38,482015113011,400400.0,29.800447906906925,-95.40269060745572,579,10,12,6,26
1237,1293,1294,1063,582,1063,237,826,819,768,13,3,33,1,1,7,885,179,706,704,664,10,3,25,1,1,2,582,515,67,482015113012,296200.0,29.79393033163712,-95.40209348917452,595,11,16,9,28
1238,1294,1295,692,338,692,288,404,392,309,56,0,25,0,2,12,560,211,349,342,275,43,0,22,0,2,7,338,310,28,482015113013,338100.0,29.79326784325741,-95.40861967913295,610,11,16,9,29
1239,1295,1296,1009,473,1009,390,619,604,554,23,3,20,0,4,15,815,287,528,520,478,19,3,18,0,2,8,473,419,54,482015113014,301300.0,29.80000425721826,-95.40884251534035,595,10,12,6,26
1240,1296,1297,1060,607,1060,174,886,873,849,9,0,15,0,0,13,896,140,756,751,729,8,0,14,0,0,5,607,539,68,482015113021,302500.0,29.80117462842072,-95.3918141233967,551,12,12,7,24
1241,1297,1298,1331,753,1331,269,1062,1038,995,24,0,14,0,5,24,1102,201,901,885,847,22,0,12,0,4,16,753,658,95,482015113022,300900.0,29.79453664694648,-95.39160790112236,567,14,15,10,27
1242,1298,1299,1240,839,1240,267,973,954,876,46,0,30,0,2,19,1102,236,866,851,780,41,0,28,0,2,15,839,745,94,482015113023,343400.0,29.79734905935989,-95.39727426823808,570,14,13,7,27
1243,1299,1300,1164,716,1164,270,894,875,848,10,2,15,0,0,19,1038,222,816,806,782,10,1,13,0,0,10,716,657,59,482015114001,262000.0,29.797094168068963,-95.38616653092956,549,15,15,7,26
1244,1300,1301,896,490,896,291,605,589,565,11,1,11,0,1,16,732,207,525,516,496,8,1,10,0,1,9,490,430,60,482015114002,251700.0,29.792442260367487,-95.37965154406402,544,13,18,10,23
1245,1301,1302,941,427,941,622,319,310,293,10,0,6,0,1,9,712,429,283,276,261,8,0,6,0,1,7,427,393,34,482015114003,171900.0,29.798227703320865,-95.38279704362364,540,14,14,7,23
1246,1302,1303,640,291,640,355,285,285,257,17,0,7,0,4,0,510,255,255,255,229,15,0,7,0,4,0,291,248,43,482015115001,114000.0,29.812240459966663,-95.3864942250328,464,12,12,6,19
1247,1303,1304,854,447,854,441,413,408,380,15,0,12,1,0,5,715,337,378,374,350,15,0,8,1,0,4,447,391,56,482015115002,218800.0,29.80699859463904,-95.38435005503584,491,13,14,6,19
1248,1304,1305,903,414,903,495,408,395,367,12,3,11,0,2,13,724,371,353,343,321,8,3,9,0,2,10,414,363,51,482015115003,127600.0,29.80698847340187,-95.38873962074908,501,12,13,6,20
1249,1305,1306,713,396,713,140,573,568,547,7,2,10,0,2,5,615,115,500,495,475,7,2,9,0,2,5,396,350,46,482015115004,327400.0,29.8061241191151,-95.39527815117836,522,12,12,6,21
1250,1306,1307,1317,695,1317,539,778,761,696,40,3,20,0,2,17,1078,392,686,671,617,31,3,19,0,1,15,695,629,66,482015115005,419800.0,29.80747699850296,-95.40263269630232,526,9,12,5,21
1251,1307,1308,763,347,763,407,356,348,270,43,4,30,0,1,8,606,290,316,311,246,39,3,22,0,1,5,347,304,43,482015115006,216100.0,29.808250559640197,-95.4091599089604,536,9,11,5,22
1252,1308,1309,1282,592,1282,601,681,649,601,23,1,23,0,1,32,1017,433,584,568,527,19,1,21,0,0,16,592,537,55,482015115007,178400.0,29.811072665826217,-95.39668024282838,485,12,10,6,20
1253,1309,1310,1051,437,1051,745,306,302,262,20,2,17,1,0,4,796,524,272,269,235,19,1,13,1,0,3,437,375,62,482015116001,148900.0,29.794928558598052,-95.37430378412212,509,14,17,10,21
1254,1310,1311,794,279,794,665,129,125,111,3,1,6,0,4,4,560,440,120,116,103,2,1,6,0,4,4,279,247,32,482015116002,95000.0,29.80052789735036,-95.37442442256804,497,14,14,7,20
1255,1311,1312,1327,516,1327,1090,237,233,199,19,0,15,0,0,4,972,750,222,219,188,17,0,14,0,0,3,516,480,36,482015116003,147200.0,29.799678291051265,-95.37949271563024,523,14,14,7,21
1256,1312,1313,1469,541,1469,1183,286,271,225,21,0,17,6,2,15,1102,841,261,251,215,17,0,15,2,2,10,541,474,67,482015116004,89600.0,29.808164009359693,-95.3778242469202,453,12,13,6,18
1257,1313,1314,1597,934,1597,856,741,727,631,38,3,53,0,2,14,1241,611,630,619,547,28,3,41,0,0,11,934,603,331,482015201001,115300.0,29.792098792788877,-95.46032488701708,575,5,9,7,30
1258,1314,1315,576,262,576,153,423,420,377,22,1,20,0,0,3,439,111,328,327,298,14,1,14,0,0,1,262,238,24,482015202001,377100.0,29.786573518299637,-95.47197185462582,532,4,11,8,30
1259,1315,1316,1368,631,1368,110,1258,1248,1109,13,2,124,0,0,10,1016,88,928,922,827,10,2,83,0,0,6,631,608,23,482015202002,466800.0,29.7892888339832,-95.48033133843528,507,6,8,6,32
1260,1316,1317,1660,665,1660,928,732,715,554,99,4,55,0,3,17,1109,560,549,543,431,60,2,49,0,1,6,665,555,110,482015202003,324400.0,29.79177130589081,-95.471868427075,518,4,7,6,30
1261,1317,1318,2089,841,2089,1391,698,674,534,86,4,47,1,2,24,1522,907,615,600,489,68,3,37,1,2,15,841,782,59,482015203001,103700.0,29.79869083996962,-95.4719427226414,504,3,8,6,28
1262,1318,1319,1444,467,1444,1158,286,284,183,67,4,26,1,3,2,1035,790,245,243,161,56,2,20,1,3,2,467,428,39,482015203002,316700.0,29.801314747635164,-95.47952645520913,476,3,7,6,30
1263,1319,1320,1593,654,1593,790,803,782,635,47,2,96,0,2,21,1223,527,696,682,551,44,2,83,0,2,14,654,574,80,482015203003,211800.0,29.797680158164265,-95.48056421651783,482,3,5,6,30
1264,1320,1321,1414,412,1414,1262,152,151,110,29,0,12,0,0,1,968,832,136,135,102,23,0,10,0,0,1,412,362,50,482015204001,115100.0,29.81095657395001,-95.48178277776772,375,4,6,6,24
1265,1321,1322,1665,661,1665,1213,452,442,328,99,4,11,0,0,10,1236,820,416,411,311,86,3,11,0,0,5,661,606,55,482015204002,101700.0,29.806382968762744,-95.47379477319828,451,4,9,6,25
1266,1322,1323,1700,572,1700,1384,316,309,253,43,5,7,0,1,7,1177,878,299,292,237,42,5,7,0,1,7,572,541,31,482015205001,31900.0,29.812733206683973,-95.46849080760792,412,3,7,6,22
1267,1323,1324,2663,1165,2663,1974,689,661,309,316,6,23,0,7,28,1861,1298,563,554,279,246,6,20,0,3,9,1165,948,217,482015205002,107400.0,29.83122560650304,-95.48451970474058,262,4,6,6,17
1268,1324,1325,1564,482,1564,1230,334,328,286,16,6,12,0,8,6,1067,779,288,284,252,14,4,9,0,5,4,482,445,37,482015205003,89900.0,29.83582145050472,-95.49887782254363,180,3,6,4,12
1269,1325,1326,1942,576,1942,1496,446,427,370,35,1,14,0,7,19,1366,983,383,371,333,25,1,7,0,5,12,576,539,37,482015205004,95500.0,29.827434950032277,-95.48771628107924,256,4,6,6,17
1270,1326,1327,2484,818,2484,1960,524,519,275,33,3,204,0,4,5,1733,1280,453,449,241,26,3,175,0,4,4,818,734,84,482015206011,97000.0,29.81680132865262,-95.49268340033252,272,4,5,4,20
1271,1327,1328,1142,421,1142,1029,113,111,82,16,3,10,0,0,2,743,648,95,93,71,12,1,9,0,0,2,421,290,131,482015206021,116700.0,29.80881886641755,-95.48711504059104,377,4,6,6,25
1272,1328,1329,1561,497,1561,1229,332,322,264,25,2,28,0,3,10,1097,805,292,283,235,21,2,25,0,0,9,497,458,39,482015206022,99800.0,29.80691256785043,-95.49843800524413,308,3,6,4,22
1273,1329,1330,1666,712,1666,1053,613,598,485,77,2,31,1,2,15,1250,706,544,535,443,61,2,27,1,1,9,712,644,68,482015206023,85200.0,29.806929127825903,-95.4926052365858,357,4,6,4,24
1274,1330,1331,1903,515,1903,1821,82,77,46,22,1,8,0,0,5,1189,1125,64,62,38,20,1,3,0,0,2,515,487,28,482015206024,81000.0,29.80494312811229,-95.48696736888702,403,4,6,6,27
1275,1331,1332,779,295,779,348,431,423,368,20,0,35,0,0,8,549,227,322,318,272,16,0,30,0,0,4,295,273,22,482015207001,228200.0,29.80094197081875,-95.48913724009849,422,3,7,5,27
1276,1332,1333,662,282,662,251,411,401,349,13,2,33,0,4,10,489,179,310,307,276,9,2,18,0,2,3,282,266,16,482015207002,249400.0,29.79695582363096,-95.489010837743,432,3,5,5,28
1277,1333,1334,997,425,997,369,628,613,502,64,1,41,1,4,15,758,251,507,500,405,59,1,30,1,4,7,425,342,83,482015207003,228300.0,29.799115294701902,-95.49600234905832,360,3,6,5,27
1278,1334,1335,1286,442,1286,524,762,755,679,37,3,36,0,0,7,974,358,616,612,548,33,3,28,0,0,4,442,417,25,482015207004,235000.0,29.79983505569088,-95.5042578560087,313,3,7,5,24
1279,1335,1336,2103,761,2103,1407,696,682,563,90,2,22,1,4,14,1414,880,534,526,450,53,2,18,1,2,8,761,645,116,482015210001,239900.0,29.79426572792055,-95.51781695188797,289,3,4,4,22
1280,1336,1337,2177,717,2177,1778,399,390,341,12,0,36,0,1,9,1561,1236,325,321,282,9,0,30,0,0,4,717,633,84,482015211001,171800.0,29.80177207794243,-95.51970769638314,274,2,5,4,21
1281,1337,1338,2601,821,2601,2348,253,246,163,36,1,39,0,7,7,1672,1465,207,202,148,21,1,29,0,3,5,821,675,146,482015212001,150500.0,29.80701477583575,-95.5037181283403,284,3,6,4,21
1282,1338,1339,1988,733,1988,1175,813,798,573,144,4,64,0,13,15,1422,749,673,668,492,107,4,59,0,6,5,733,689,44,482015212002,140700.0,29.806846529253328,-95.51761821427635,260,2,6,2,18
1283,1339,1340,1739,805,1739,1196,543,527,289,154,2,70,0,12,16,1343,855,488,474,279,125,1,61,0,8,14,805,670,135,482015212003,35500.0,29.8069717974359,-95.50954844098084,282,3,6,4,20
1284,1340,1341,944,291,944,598,346,336,257,5,0,73,1,0,10,665,371,294,286,222,5,0,58,1,0,8,291,280,11,482015213001,108100.0,29.818848379622946,-95.52194112595753,192,2,3,2,15
1285,1341,1342,1289,411,1289,881,408,401,204,156,1,40,0,0,7,857,548,309,306,176,94,1,35,0,0,3,411,369,42,482015213002,124100.0,29.81853486514597,-95.51355582339905,201,3,5,4,16
1286,1342,1343,1034,302,1034,748,286,274,238,10,2,22,0,2,12,745,502,243,235,208,8,2,15,0,2,8,302,295,7,482015213003,105700.0,29.816110322503494,-95.50507287133742,219,3,5,4,17
1287,1343,1344,2172,872,2172,1349,823,806,501,108,2,191,0,4,17,1594,887,707,698,440,86,2,166,0,4,9,872,808,64,482015213004,146500.0,29.81309815217725,-95.51822485157524,214,2,5,2,15
1288,1344,1345,1242,365,1242,1177,65,63,29,20,0,13,0,1,2,803,763,40,38,15,13,0,9,0,1,2,365,304,61,482015214001,,29.83105756277115,-95.5079931361972,184,3,6,4,13
1289,1345,1346,2232,710,2232,2173,59,59,47,4,0,6,0,2,0,1440,1389,51,51,41,3,0,5,0,2,0,710,651,59,482015214002,,29.82891526419847,-95.50133829582433,192,3,6,4,13
1290,1346,1347,1478,458,1478,1129,349,346,318,9,0,15,0,4,3,1081,764,317,315,289,7,0,15,0,4,2,458,427,31,482015214003,100300.0,29.823050463638,-95.50176117019252,200,3,5,4,13
1291,1347,1348,2641,714,2641,2492,149,144,115,16,2,7,0,4,5,1715,1609,106,103,85,9,2,6,0,1,3,714,688,26,482015214004,85800.0,29.82658780371945,-95.50599078257086,189,3,6,4,13
1292,1348,1349,1357,351,1357,1140,217,210,117,48,0,43,2,0,7,930,761,169,167,104,24,0,37,2,0,2,351,330,21,482015215001,116200.0,29.82749300575605,-95.52469713657992,165,2,4,2,11
1293,1349,1350,1104,353,1104,701,403,394,314,37,1,34,0,8,9,792,453,339,333,273,29,1,25,0,5,6,353,331,22,482015215002,117600.0,29.82917030915916,-95.52097147542108,154,2,4,2,11
1294,1350,1351,1387,467,1387,1105,282,279,206,32,3,34,0,4,3,940,711,229,228,175,19,3,28,0,3,1,467,437,30,482015215003,130000.0,29.823389213755576,-95.52158739758056,167,2,3,2,11
1295,1351,1352,2049,761,2049,947,1102,1078,897,47,4,127,1,2,24,1577,624,953,939,799,38,4,96,1,1,14,761,731,30,482015215004,131800.0,29.826973100599226,-95.51341461624204,174,3,6,4,12
1296,1352,1353,2095,580,2095,1560,535,526,403,45,1,72,2,3,9,1412,985,427,420,337,31,1,50,0,1,7,580,555,25,482015216001,122200.0,29.839463426815566,-95.528506825916,157,3,5,2,9
1297,1353,1354,1537,455,1537,953,584,578,33,537,0,6,0,2,6,1016,585,431,427,27,395,0,4,0,1,4,455,401,54,482015216002,82300.0,29.851993956166847,-95.54009049917283,152,2,5,3,8
1298,1354,1355,1376,731,1376,910,466,458,133,310,2,6,6,1,8,998,632,366,360,120,228,2,6,3,1,6,731,574,157,482015217001,,29.84395222181848,-95.50164502607112,177,3,7,4,12
1299,1355,1356,1824,889,1824,1224,600,574,206,331,1,32,0,4,26,1303,824,479,465,187,249,1,28,0,0,14,889,705,184,482015217002,113500.0,29.84777029136925,-95.51826988873192,151,3,6,2,9
1300,1356,1357,2109,944,2109,1551,558,542,198,287,4,51,0,2,16,1510,1070,440,428,172,207,1,46,0,2,12,944,793,151,482015217003,84500.0,29.846149918012763,-95.51042905946346,174,4,7,4,11
1301,1357,1358,791,483,791,370,421,410,208,162,1,36,0,3,11,606,241,365,357,193,129,1,32,0,2,8,483,383,100,482015217004,38800.0,29.858584726489298,-95.53207927626777,98,3,4,3,7
1302,1359,1360,2926,923,2926,1699,1227,1205,553,129,2,521,0,0,22,2163,1143,1020,1006,483,97,1,425,0,0,14,923,886,37,482015218002,108300.0,29.83713088123716,-95.55088429477188,139,2,5,3,9
1303,1360,1361,3095,1436,3095,523,2572,2527,2110,88,3,324,0,2,45,2616,374,2242,2217,1854,64,3,294,0,2,25,1436,1250,186,482015219001,188800.0,29.82456107372539,-95.55431418525406,151,1,3,3,10
1304,1361,1362,2232,770,2232,1410,822,804,516,142,3,132,0,11,18,1493,819,674,663,454,95,2,104,0,8,11,770,721,49,482015219002,93100.0,29.81394428510492,-95.55420813073844,159,1,3,3,12
1305,1362,1363,1210,348,1210,770,440,430,199,24,4,202,0,1,10,878,516,362,356,161,17,4,173,0,1,6,348,331,17,482015219003,112000.0,29.816199946599195,-95.55560189015416,159,2,3,3,12
1306,1363,1364,1714,1182,1714,406,1308,1295,1112,95,0,87,0,1,13,1573,328,1245,1235,1063,89,0,82,0,1,10,1182,1088,94,482015220001,157300.0,29.828098917512524,-95.53941675199412,160,2,4,2,10
1307,1364,1365,852,279,852,519,333,328,287,14,1,26,0,0,5,599,315,284,283,250,11,1,21,0,0,1,279,271,8,482015220002,127400.0,29.828704311617805,-95.52890068423196,162,2,4,2,10
1308,1365,1366,1868,657,1868,1462,406,397,297,52,1,47,0,0,9,1330,999,331,325,251,31,1,42,0,0,6,657,508,149,482015220003,113700.0,29.824314639497302,-95.53238722178342,164,2,3,2,10
1309,1366,1367,1757,864,1757,931,826,804,514,159,1,128,0,2,22,1339,640,699,685,451,128,1,104,0,1,14,864,773,91,482015221001,176700.0,29.82057633196425,-95.54108035724067,173,1,3,2,12
1310,1367,1368,1523,563,1523,684,839,831,747,37,8,38,0,1,8,1179,452,727,723,651,28,8,35,0,1,4,563,536,27,482015221002,153900.0,29.81226585720267,-95.53143668974384,211,2,3,2,15
1311,1368,1369,2816,840,2816,1894,922,900,474,405,4,15,1,1,22,1743,1077,666,656,421,215,4,14,1,1,10,840,761,79,482015221003,142800.0,29.818403975501457,-95.53154980139992,195,2,3,2,14
1312,1369,1370,1349,589,1349,688,661,651,484,119,6,42,0,0,10,1008,457,551,543,420,91,4,28,0,0,8,589,533,56,482015221004,161800.0,29.815559631025494,-95.54103653249771,182,1,3,2,14
1313,1370,1371,1460,510,1460,1168,292,285,133,105,2,40,0,5,7,953,738,215,213,108,70,2,31,0,2,2,510,395,115,482015222011,73800.0,29.80168294588809,-95.52760049773828,273,2,3,4,20
1314,1371,1372,2227,841,2227,1245,982,969,807,67,2,89,1,3,13,1662,821,841,836,707,48,1,80,0,0,5,841,768,73,482015222012,150200.0,29.80886047423458,-95.5373364960756,236,2,3,2,16
1315,1372,1373,1785,735,1785,1186,599,588,439,81,6,55,0,7,11,1235,738,497,489,375,58,3,50,0,3,8,735,551,184,482015222021,130800.0,29.803646533190868,-95.53780082616676,253,2,3,3,18
1316,1373,1374,1870,619,1870,1158,712,696,467,143,2,75,0,9,16,1311,731,580,572,410,89,2,64,0,7,8,619,566,53,482015222022,147000.0,29.797771055851545,-95.5379767355792,261,2,3,4,19
1317,1374,1375,1502,647,1502,630,872,844,722,48,8,65,1,0,28,1185,427,758,745,634,46,6,58,1,0,13,647,595,52,482015223011,141600.0,29.7934859413089,-95.5280293345142,286,3,3,4,21
1318,1375,1376,2624,955,2624,1938,686,668,370,194,6,92,0,6,18,1774,1232,542,532,317,127,5,79,0,4,10,955,878,77,482015223012,120800.0,29.78746646965188,-95.52593717769724,295,6,3,4,23
1319,1376,1377,2109,659,2109,1808,301,296,158,47,1,86,0,4,5,1514,1266,248,246,133,35,1,75,0,2,2,659,590,69,482015223021,131300.0,29.78941961770874,-95.5422418741062,265,5,3,4,20
1320,1377,1378,1800,856,1800,866,934,917,752,53,2,102,1,7,17,1434,598,836,824,685,43,2,90,1,3,12,856,775,81,482015223022,151000.0,29.78920682843803,-95.53589741491572,279,6,3,4,20
1321,1378,1379,880,361,880,236,644,622,576,11,1,27,2,5,22,718,162,556,543,505,8,1,26,2,1,13,361,346,15,482015224011,163300.0,29.808527273602365,-95.54972991886598,209,1,3,3,16
1322,1379,1380,1197,509,1197,290,907,895,813,27,3,49,0,3,12,966,188,778,770,701,19,2,46,0,2,8,509,483,26,482015224012,159800.0,29.800418305722346,-95.54869721730324,235,1,4,5,18
1323,1380,1381,1696,865,1696,939,757,747,609,59,7,53,2,17,10,1274,657,617,611,498,48,7,47,2,9,6,865,613,252,482015224013,107500.0,29.79421480170553,-95.54993066930096,234,1,3,5,17
1324,1381,1382,1486,514,1486,1266,220,202,112,32,0,54,0,4,18,994,833,161,147,83,20,0,40,0,4,14,514,418,96,482015224014,153100.0,29.787528722148316,-95.54891334505356,243,4,3,5,19
1325,1382,1383,3020,951,3020,1947,1073,1049,891,83,4,58,4,9,24,2032,1138,894,876,769,51,4,42,3,7,18,951,895,56,482015224021,153700.0,29.80495109203363,-95.55882368579012,199,2,3,4,17
1326,1383,1384,900,361,900,386,514,512,422,29,8,45,1,7,2,680,250,430,429,366,18,6,35,1,3,1,361,342,19,482015224022,134800.0,29.79088379439112,-95.55835324818784,220,3,3,5,17
1327,1384,1385,0,0,0,0,0,0,0,0,0,0,0,0,0,0,0,0,0,0,0,0,0,0,0,0,0,0,0,482015225001,474300.0,29.78413501013544,-95.48562544133748,473,6,5,6,33
1328,1385,1386,973,391,973,847,126,121,42,71,0,8,0,0,5,672,567,105,100,33,60,0,7,0,0,5,391,321,70,482015301001,,29.81645271376712,-95.46246354942768,396,3,7,6,20
1329,1386,1387,2419,1050,2419,1731,688,680,392,273,1,7,0,7,8,1725,1139,586,580,357,211,1,6,0,5,6,1050,833,217,482015301002,113000.0,29.816413638653053,-95.45524340553082,416,4,5,4,20
1330,1387,1388,1241,496,1241,884,357,350,246,91,2,7,0,4,7,855,545,310,305,221,74,2,7,0,1,5,496,426,70,482015301003,166800.0,29.80884052914556,-95.45121060075635,512,6,9,5,23
1331,1388,1389,1600,798,1600,1093,507,498,330,152,1,10,0,5,9,1220,765,455,446,306,128,1,9,0,2,9,798,687,111,482015301004,157200.0,29.813667508837963,-95.4468735210902,471,6,8,5,23
1332,1389,1390,1124,648,1124,254,870,852,794,23,1,33,0,1,18,890,182,708,697,650,20,1,25,0,1,11,648,477,171,482015302001,322200.0,29.816029610858948,-95.40682340584937,445,9,9,5,21
1333,1390,1391,1501,729,1501,658,843,824,732,34,6,48,2,2,19,1214,472,742,727,651,23,5,45,2,1,15,729,617,112,482015302002,154200.0,29.8160297310478,-95.42514673529668,467,7,9,5,22
1334,1391,1392,748,297,748,333,415,410,357,40,4,8,0,1,5,611,235,376,374,322,39,4,8,0,1,2,297,287,10,482015302003,134800.0,29.81523583835043,-95.44056991325404,472,7,11,5,23
1335,1392,1393,688,332,688,202,486,477,5,470,1,0,0,1,9,525,116,409,403,5,396,1,0,0,1,6,332,265,67,482015303001,66700.0,29.82065903872059,-95.39075318272567,382,12,10,6,16
1336,1393,1394,504,283,504,150,354,347,9,334,1,0,0,3,7,397,85,312,306,8,295,0,0,0,3,6,283,220,63,482015303002,32900.0,29.81589378846457,-95.39647586871634,430,12,9,6,18
1337,1394,1395,1208,616,1208,337,871,868,24,833,4,3,0,4,3,911,194,717,715,21,685,3,2,0,4,2,616,463,153,482015303003,54800.0,29.81658353126445,-95.38497062088658,412,12,10,6,18
1338,1395,1396,1620,647,1620,681,939,935,26,901,0,8,0,0,4,1217,435,782,781,20,755,0,6,0,0,1,647,549,98,482015304001,70600.0,29.82660960150536,-95.39238580275932,339,10,7,5,14
1339,1396,1397,982,428,982,422,560,555,95,454,3,2,0,1,5,764,266,498,493,94,393,3,2,0,1,5,428,365,63,482015304002,55300.0,29.82567048972623,-95.38379569788744,335,10,10,5,13
1340,1397,1398,1525,540,1525,701,824,818,58,743,3,8,1,5,6,1071,417,654,650,45,590,3,8,1,3,4,540,468,72,482015305001,76100.0,29.839353745626383,-95.39958110517642,274,7,6,4,9
1341,1398,1399,1642,661,1642,817,825,823,98,715,4,4,0,2,2,1246,557,689,689,82,599,2,4,0,2,0,661,526,135,482015305002,96500.0,29.839159440375013,-95.39236680644424,273,10,6,5,9
1342,1399,1400,1596,647,1596,911,685,680,50,611,3,10,0,6,5,1125,564,561,557,40,501,2,10,0,4,4,647,519,128,482015305003,73400.0,29.832929955042243,-95.39600288506928,290,10,6,5,11
1343,1400,1401,2119,715,2119,1168,951,930,417,493,4,11,0,5,21,1564,720,844,829,388,421,4,11,0,5,15,715,638,77,482015306001,53800.0,29.839170731640262,-95.4069891014839,278,7,6,4,10
1344,1401,1402,1493,681,1493,740,753,747,128,610,1,7,0,1,6,1109,470,639,634,117,508,1,7,0,1,5,681,526,155,482015306002,95200.0,29.824923912639136,-95.40375281669284,360,7,9,4,15
1345,1402,1403,1712,575,1712,1400,312,309,144,160,1,2,0,2,3,1181,925,256,253,118,132,1,2,0,0,3,575,487,88,482015307001,88100.0,29.850215484991622,-95.39966746367313,214,6,7,4,9
1346,1403,1404,2500,799,2500,1580,920,909,196,701,4,4,0,4,11,1571,971,600,597,181,407,3,4,0,2,3,799,768,31,482015307002,91500.0,29.852718792530727,-95.40727821199292,214,6,7,4,10
1347,1404,1405,1394,432,1394,627,767,767,103,657,0,7,0,0,0,949,409,540,540,95,438,0,7,0,0,0,432,405,27,482015307003,48700.0,29.86307551337217,-95.4088227868686,190,5,6,4,9
1348,1405,1406,1216,531,1216,175,1041,1028,52,968,6,2,0,0,13,912,108,804,794,22,764,6,2,0,0,10,531,443,88,482015308001,50700.0,29.86086294248559,-95.41774569389236,206,5,5,4,10
1349,1406,1407,812,312,812,115,697,696,16,679,1,0,0,0,1,584,74,510,510,13,497,0,0,0,0,0,312,274,38,482015308002,47000.0,29.855769625022244,-95.42417709805316,215,4,5,4,11
1350,1407,1408,1821,863,1821,229,1592,1582,203,1369,2,6,0,2,10,1531,148,1383,1375,183,1183,2,5,0,2,8,863,802,61,482015308003,151200.0,29.84616078518486,-95.4201442286398,242,5,5,4,10
1351,1408,1409,1152,420,1152,867,285,273,193,76,1,2,0,1,12,817,574,243,237,170,63,1,2,0,1,6,420,358,62,482015309001,139400.0,29.836239789889014,-95.41355394783488,285,6,5,4,10
1352,1409,1410,1584,701,1584,443,1141,1125,761,346,1,13,0,4,16,1225,290,935,924,658,250,1,12,0,3,11,701,659,42,482015309002,224800.0,29.838617376086884,-95.4230108439165,294,5,5,4,11
1353,1410,1411,1451,632,1451,221,1230,1220,1185,14,4,16,0,1,10,1180,159,1021,1016,985,13,4,13,0,1,5,632,611,21,482015309003,235600.0,29.83364358026668,-95.42264865406568,309,5,5,4,11
1354,1411,1412,1320,619,1320,346,974,957,907,14,5,30,0,1,17,1050,240,810,802,758,14,3,26,0,1,8,619,578,41,482015310001,211200.0,29.824582985875907,-95.42576787717888,382,5,9,4,17
1355,1412,1413,2309,1046,2309,747,1562,1532,1470,27,5,28,0,2,30,1784,508,1276,1258,1204,25,2,25,0,2,18,1046,961,85,482015310002,273800.0,29.82554682189583,-95.41645384997048,368,6,9,4,16
1356,1413,1414,1152,584,1152,291,861,847,812,14,3,18,0,0,14,956,207,749,740,709,13,2,16,0,0,9,584,546,38,482015311001,150600.0,29.825456744156693,-95.4421029246,378,5,10,4,18
1357,1414,1415,1702,753,1702,663,1039,1022,953,37,9,20,2,1,17,1330,443,887,877,817,28,9,20,2,1,10,753,694,59,482015311002,147900.0,29.824500349698248,-95.43488278522696,379,5,10,4,17
1358,1415,1416,1066,521,1066,646,420,411,184,218,3,3,3,0,9,718,413,305,302,168,128,3,3,0,0,3,521,359,162,482015312001,133800.0,29.82706622022433,-95.4560329199918,330,4,4,4,15
1359,1416,1417,1276,657,1276,292,984,974,914,9,0,48,0,3,10,1090,214,876,870,814,9,0,44,0,3,6,657,619,38,482015312002,157200.0,29.82879233090131,-95.44947048001106,329,4,6,4,16
1360,1417,1418,820,427,820,203,617,610,563,36,4,5,1,1,7,692,160,532,529,485,33,4,5,1,1,3,427,403,24,482015312003,163900.0,29.823057523401676,-95.4476904885487,367,4,7,4,18
1361,1418,1419,1884,727,1884,1518,366,344,136,196,2,8,0,2,22,1262,971,291,282,124,150,2,4,0,2,9,727,578,149,482015313001,,29.81891761762787,-95.45258480723936,395,6,7,4,20
1362,1419,1420,1513,709,1513,495,1018,998,882,68,2,45,0,1,20,1280,359,921,905,796,63,2,43,0,1,16,709,668,41,482015313002,110100.0,29.82390680573152,-95.46753858058464,324,3,6,6,17
1363,1420,1421,1983,1075,1983,1227,756,745,268,447,1,22,1,6,11,1473,839,634,626,247,353,1,21,1,3,8,1075,890,185,482015313003,,29.82336851958152,-95.459175393849,350,4,6,4,16
1364,1421,1422,2053,1015,2053,788,1265,1240,1161,39,4,36,0,0,25,1683,547,1136,1118,1051,32,4,31,0,0,18,1015,964,51,482015314001,118200.0,29.83020821584741,-95.47100222407174,292,4,6,6,16
1365,1422,1423,945,421,945,355,590,583,552,13,3,13,0,2,7,767,253,514,511,486,9,3,13,0,0,3,421,401,20,482015315001,136000.0,29.83636835215336,-95.46894360130236,285,3,6,6,14
1366,1423,1424,655,283,655,265,390,390,364,11,2,13,0,0,0,538,200,338,338,319,5,2,12,0,0,0,283,272,11,482015315002,131600.0,29.834989962809495,-95.47610914134584,269,4,6,6,15
1367,1424,1425,1420,602,1420,665,755,747,527,178,1,40,0,1,8,1088,462,626,622,460,127,1,33,0,1,4,602,562,40,482015315003,143600.0,29.837831083528968,-95.48206868212584,263,4,5,6,15
1368,1425,1426,1473,700,1473,323,1150,1121,1043,59,4,15,0,0,29,1185,226,959,945,887,45,3,10,0,0,14,700,648,52,482015316001,213100.0,29.83818728721276,-95.4494521069668,308,4,4,4,13
1369,1426,1427,1350,540,1350,701,649,640,556,75,1,7,0,1,9,1033,461,572,566,492,65,1,7,0,1,6,540,508,32,482015316002,136500.0,29.837279133676617,-95.46057668532848,309,3,5,4,13
1370,1427,1428,1244,589,1244,196,1048,1033,964,36,6,24,0,3,15,999,143,856,846,801,19,5,20,0,1,10,589,548,41,482015317001,195600.0,29.838381665597822,-95.43675206664098,297,5,6,4,12
1371,1428,1429,1585,793,1585,336,1249,1232,1180,24,1,23,2,2,17,1308,246,1062,1053,1008,18,1,22,2,2,9,793,740,53,482015317002,168500.0,29.83234603657106,-95.43446672072332,326,5,6,4,14
1372,1429,1430,1756,634,1756,328,1428,1414,40,1365,7,0,0,2,14,1201,174,1027,1019,27,983,7,0,0,2,8,634,562,72,482015318001,57800.0,29.851976409441345,-95.43532994139063,235,4,7,4,11
1373,1430,1431,596,271,596,158,438,433,21,410,1,1,0,0,5,464,100,364,361,19,340,1,1,0,0,3,271,221,50,482015318002,78700.0,29.86072709119185,-95.44127898430148,220,4,5,4,12
1374,1431,1432,1804,600,1804,395,1409,1405,38,1360,2,4,0,1,4,1213,258,955,952,28,917,2,4,0,1,3,600,566,34,482015319001,85500.0,29.84523194270884,-95.45115702380828,265,4,4,4,13
1375,1432,1433,1383,438,1383,479,904,888,9,878,1,0,0,0,16,963,288,675,663,6,656,1,0,0,0,12,438,401,37,482015319002,76400.0,29.858546653624515,-95.44855818221394,223,4,4,4,13
1376,1433,1434,1521,586,1521,168,1353,1348,18,1316,0,14,0,0,5,1085,101,984,980,13,953,0,14,0,0,4,586,539,47,482015319003,91200.0,29.854904580624417,-95.45550123375324,241,4,4,4,13
1377,1434,1435,1202,839,1202,248,954,931,46,870,1,13,0,1,23,816,160,656,643,44,589,0,10,0,0,13,839,483,356,482015320011,,29.85998421571847,-95.47540739796258,193,4,6,5,13
1378,1435,1436,618,818,618,96,522,518,147,356,5,7,0,3,4,525,68,457,454,134,309,3,7,0,1,3,818,329,489,482015320012,170400.0,29.85133591297788,-95.4675736544476,243,3,7,6,14
1379,1436,1437,990,725,990,238,752,750,168,572,2,8,0,0,2,703,160,543,543,154,381,2,6,0,0,0,725,400,325,482015320013,129200.0,29.85948667473641,-95.46875254870086,206,3,6,5,13
1380,1437,1438,2057,1407,2057,886,1171,1152,100,1032,5,12,0,3,19,1375,559,816,804,85,702,4,10,0,3,12,1407,782,625,482015320014,151600.0,29.856067545774607,-95.46812116292308,217,3,6,6,14
1381,1438,1439,1008,431,1008,322,686,670,498,156,3,10,0,3,16,794,223,571,559,417,131,3,5,0,3,12,431,408,23,482015320021,154300.0,29.84547453627827,-95.46544398061133,264,3,6,6,14
1382,1439,1440,2275,991,2275,1349,926,912,266,585,4,57,0,0,14,1604,887,717,703,228,417,3,55,0,0,14,991,863,128,482015321001,46500.0,29.84310595743324,-95.47386935588293,252,4,6,6,14
1383,1440,1441,715,300,715,278,437,428,54,362,0,12,0,0,9,480,168,312,306,51,244,0,11,0,0,6,300,242,58,482015321002,56800.0,29.847636604586786,-95.47430839695988,235,4,6,6,15
1384,1441,1442,1438,611,1438,415,1023,1009,899,67,5,34,3,1,14,1186,292,894,885,798,48,5,31,2,1,9,611,589,22,482015321003,132800.0,29.84476482252549,-95.48120280212947,243,4,5,6,15
1385,1442,1443,1349,847,1349,621,728,717,106,606,1,3,0,1,11,902,404,498,493,70,418,1,3,0,1,5,847,504,343,482015321004,,29.84674272854015,-95.48503862821916,224,4,6,6,15
1386,1443,1444,1078,676,1078,392,686,681,54,619,1,3,0,4,5,718,269,449,445,46,394,1,3,0,1,4,676,385,291,482015322001,,29.851533484546067,-95.47617501350295,224,4,7,6,15
1387,1444,1445,1712,793,1712,619,1093,1075,345,707,5,17,0,1,18,1203,363,840,826,334,471,4,16,0,1,14,793,703,90,482015322002,84000.0,29.857430579389018,-95.48316461945942,194,4,6,5,14
1388,1445,1446,1122,478,1122,407,715,710,645,47,6,9,0,3,5,888,268,620,617,564,39,6,6,0,2,3,478,454,24,482015323001,114700.0,29.854150370983174,-95.49467860564606,164,4,6,4,12
1389,1446,1447,73,29,73,19,54,54,31,7,0,16,0,0,0,61,16,45,45,26,4,0,15,0,0,0,29,27,2,482015323002,,29.86022433119092,-95.51658573772612,102,3,6,4,7
1390,1447,1448,1736,884,1736,693,1043,1032,303,646,1,76,1,5,11,1248,462,786,782,272,440,1,64,1,4,4,884,728,156,482015323003,,29.858807568688054,-95.50277800922724,137,3,6,3,11
1391,1448,1449,2589,1445,2589,990,1599,1562,481,938,1,122,2,18,37,1983,664,1319,1293,438,736,1,103,2,13,26,1445,1280,165,482015323004,161500.0,29.857530869300724,-95.50782380301024,144,3,6,5,10
1392,1450,1451,2334,788,2334,1167,1167,1144,819,196,11,117,0,1,23,1664,744,920,903,682,127,6,88,0,0,17,788,754,34,482015324002,112600.0,29.869862941216194,-95.4956028583906,129,4,6,3,11
1393,1451,1452,224,76,224,124,100,100,76,22,0,0,1,1,0,164,83,81,81,67,12,0,0,1,1,0,76,74,2,482015324003,115000.0,29.87255713362913,-95.49953155756872,122,3,6,3,10
1394,1453,1454,1144,359,1144,779,365,352,249,89,1,9,0,4,13,775,464,311,298,231,59,0,7,0,1,13,359,339,20,482015325021,130500.0,29.882152506475133,-95.49825505855932,93,3,6,2,7
1395,1454,1455,1450,377,1450,1115,335,328,172,84,5,63,0,4,7,956,702,254,250,140,52,2,53,0,3,4,377,363,14,482015325022,114000.0,29.891264162471582,-95.49840965009216,69,3,5,1,5
1396,1455,1456,2968,799,2968,2382,586,575,299,233,1,36,0,6,11,1950,1492,458,453,259,160,1,30,0,3,5,799,765,34,482015325023,84900.0,29.878996901692844,-95.50358778553618,104,3,6,4,7
1397,1457,1458,1409,453,1409,632,777,763,180,555,1,25,0,2,14,1009,412,597,595,167,406,1,21,0,0,2,453,426,27,482015326002,107800.0,29.887271104569844,-95.4895393355516,107,4,7,2,9
1398,1459,1460,947,409,947,229,718,694,255,393,4,38,2,2,24,763,154,609,596,242,311,2,37,2,2,13,409,385,24,482015327001,104800.0,29.879691298680854,-95.47703260283387,128,4,5,4,9
1399,1460,1461,851,320,851,269,582,581,277,292,2,9,0,1,1,650,172,478,477,246,221,1,8,0,1,1,320,298,22,482015327002,128400.0,29.873310070185703,-95.48358546283254,171,4,6,5,13
1400,1461,1462,866,323,866,318,548,542,274,254,3,10,0,1,6,676,217,459,455,256,188,3,7,0,1,4,323,304,19,482015327003,115900.0,29.87034943146173,-95.4772343252215,184,4,5,5,13
1401,1462,1463,1684,718,1684,731,953,936,389,473,4,66,2,2,17,1242,484,758,748,353,336,3,53,2,1,10,718,613,105,482015328001,113100.0,29.872757946031246,-95.4714775017236,186,4,5,5,13
1402,1463,1464,151,104,151,112,39,39,4,35,0,0,0,0,0,87,61,26,26,4,22,0,0,0,0,0,104,46,58,482015329001,97300.0,29.88403793376416,-95.46857673210206,124,3,5,3,9
1403,1464,1465,262,191,262,239,23,23,3,20,0,0,0,0,0,170,152,18,18,3,15,0,0,0,0,0,191,88,103,482015329002,104800.0,29.884272905426755,-95.4711638585932,121,4,5,3,9
1404,1465,1466,1416,727,1416,424,992,981,22,940,8,10,0,1,11,1025,270,755,750,20,714,8,8,0,0,5,727,530,197,482015330001,68100.0,29.88681089749527,-95.46056661912934,132,3,4,1,8
1405,1466,1467,1828,718,1828,584,1244,1224,346,821,13,42,0,2,20,1323,371,952,940,311,584,8,36,0,1,12,718,619,99,482015331001,111100.0,29.875104132496787,-95.46477223325688,179,3,5,5,10
1406,1467,1468,2230,798,2230,264,1966,1957,6,1938,4,9,0,0,9,1397,148,1249,1245,6,1229,1,9,0,0,4,798,755,43,482015331002,114800.0,29.876555909843507,-95.44834284873431,165,4,3,3,8
1407,1468,1469,2391,796,2391,741,1650,1624,173,1404,2,43,0,2,26,1716,485,1231,1218,155,1020,2,39,0,2,13,796,762,34,482015331003,91900.0,29.876889973225943,-95.45739080019436,160,4,3,3,8
1408,1469,1470,931,389,931,106,825,817,3,810,2,2,0,0,8,676,56,620,613,3,606,2,2,0,0,7,389,333,56,482015332001,82300.0,29.86681936253681,-95.44063168244077,209,4,5,4,12
1409,1470,1471,1049,481,1049,298,751,739,40,679,7,13,0,0,12,712,192,520,513,35,466,2,10,0,0,7,481,339,142,482015332002,91400.0,29.867015287651142,-95.4539885995911,214,4,4,4,12
1410,1471,1472,1242,656,1242,247,995,981,139,793,0,48,0,1,14,969,170,799,791,130,615,0,46,0,0,8,656,519,137,482015332003,178200.0,29.866859600815044,-95.46310068864516,214,3,6,5,12
1411,1472,1473,2368,915,2368,511,1857,1833,23,1785,3,20,0,2,24,1693,335,1358,1347,18,1305,2,20,0,2,11,915,844,71,482015333001,83000.0,29.88270145637234,-95.42459703724148,135,4,4,2,7
1412,1473,1474,1970,735,1970,285,1685,1667,28,1636,1,0,1,1,18,1331,171,1160,1150,22,1125,1,0,1,1,10,735,674,61,482015333002,61400.0,29.874201298082813,-95.41620950221365,190,5,4,4,9
1413,1474,1475,651,288,651,65,586,584,3,581,0,0,0,0,2,511,46,465,464,3,461,0,0,0,0,1,288,236,52,482015333003,54600.0,29.867855314264222,-95.42517673998896,206,4,4,4,11
1414,1475,1476,891,375,891,52,839,834,7,813,5,5,0,4,5,712,34,678,673,7,653,5,5,0,3,5,375,336,39,482015333004,55200.0,29.874587955957917,-95.42537329347024,194,4,4,4,10
1415,1476,1477,1573,615,1573,138,1435,1423,15,1402,1,1,1,3,12,1183,78,1105,1100,15,1080,1,1,1,2,5,615,567,48,482015334001,63900.0,29.8780210544313,-95.43672194361086,149,4,4,3,8
1416,1477,1478,0,0,0,0,0,0,0,0,0,0,0,0,0,0,0,0,0,0,0,0,0,0,0,0,0,0,0,482015334003,87900.0,29.88593601656861,-95.43117890878122,128,4,4,1,7
1417,1478,1479,2062,597,2062,1080,982,975,65,882,1,20,0,7,7,1397,650,747,744,57,669,0,13,0,5,3,597,570,27,482015334004,87200.0,29.891125422918066,-95.4278579857762,103,4,4,1,6
1418,1479,1480,2069,605,2069,1372,697,674,250,301,4,118,0,1,23,1462,878,584,566,232,242,3,88,0,1,18,605,581,24,482015335001,106200.0,29.88730377732085,-95.4162679186564,119,5,4,1,6
1419,1480,1481,1447,410,1447,972,475,474,256,189,1,28,0,0,1,991,597,394,393,229,140,1,23,0,0,1,410,393,17,482015335002,98400.0,29.896740556399678,-95.41678148164472,85,5,4,1,2
1420,1481,1482,846,253,846,627,219,210,98,101,0,11,0,0,9,593,416,177,169,86,72,0,11,0,0,8,253,245,8,482015335003,108400.0,29.89525377773064,-95.42461389999264,93,4,4,1,3
1421,1482,1483,2,1,2,2,0,0,0,0,0,0,0,0,0,2,2,0,0,0,0,0,0,0,0,0,1,1,0,482015336001,68600.0,29.908801378489294,-95.4141603246196,69,4,3,1,1
1422,1483,1484,767,240,767,736,31,30,9,17,1,3,0,0,1,478,458,20,19,5,12,0,2,0,0,1,240,204,36,482015337011,,29.923593293903597,-95.41536524147632,85,4,2,0,1
1423,1484,1485,1663,738,1663,1411,252,243,60,143,0,36,0,4,9,1100,898,202,196,50,109,0,34,0,3,6,738,549,189,482015337013,91200.0,29.93706375078477,-95.41777433917647,73,4,2,0,1
1424,1485,1486,0,0,0,0,0,0,0,0,0,0,0,0,0,0,0,0,0,0,0,0,0,0,0,0,0,0,0,482015338011,106600.0,29.91252736585768,-95.4787945030468,85,5,4,3,3
1425,1486,1487,0,0,0,0,0,0,0,0,0,0,0,0,0,0,0,0,0,0,0,0,0,0,0,0,0,0,0,482015339013,108800.0,29.91553452253093,-95.48507381034004,93,5,5,3,3
1426,1487,1488,0,0,0,0,0,0,0,0,0,0,0,0,0,0,0,0,0,0,0,0,0,0,0,0,0,0,0,482015339021,95800.0,29.92995743580764,-95.50674070988866,90,4,5,6,2
1427,1488,1489,39,10,39,23,16,16,0,11,0,5,0,0,0,25,12,13,13,0,8,0,5,0,0,0,10,10,0,482015339022,93900.0,29.921538467858745,-95.49523184370452,75,5,5,3,3
1428,1491,1492,0,0,0,0,0,0,0,0,0,0,0,0,0,0,0,0,0,0,0,0,0,0,0,0,0,0,0,482015340022,95000.0,29.925005968405564,-95.51101114039034,79,4,6,5,1
1429,1493,1494,0,0,0,0,0,0,0,0,0,0,0,0,0,0,0,0,0,0,0,0,0,0,0,0,0,0,0,482015342031,15800.0,29.86477622650827,-95.53399261155432,102,3,4,3,6
1430,1495,1496,0,0,0,0,0,0,0,0,0,0,0,0,0,0,0,0,0,0,0,0,0,0,0,0,0,0,0,482015401002,340200.0,29.837721403377834,-95.58486118873437,153,3,6,3,8
1431,1496,1497,0,0,0,0,0,0,0,0,0,0,0,0,0,0,0,0,0,0,0,0,0,0,0,0,0,0,0,482015401003,100900.0,29.870342340097544,-95.5654309000847,110,3,4,4,6
1432,1497,1498,2654,1006,2654,1597,1057,1039,596,170,5,260,5,3,18,1960,1085,875,862,510,129,5,213,5,0,13,1006,938,68,482015402001,93900.0,29.82229248573669,-95.56977303119815,173,2,3,3,11
1433,1498,1499,461,188,461,355,106,102,45,40,0,16,0,1,4,287,211,76,74,37,27,0,10,0,0,2,188,147,41,482015405011,118400.0,29.843705064571694,-95.64438534097906,165,2,4,4,5
1434,1499,1500,0,0,0,0,0,0,0,0,0,0,0,0,0,0,0,0,0,0,0,0,0,0,0,0,0,0,0,482015405012,,29.86402313727892,-95.64501424168532,105,1,4,3,3
1435,1500,1501,0,0,0,0,0,0,0,0,0,0,0,0,0,0,0,0,0,0,0,0,0,0,0,0,0,0,0,482015405013,,29.85749955515698,-95.64502857428562,123,2,4,6,4
1436,1501,1502,0,0,0,0,0,0,0,0,0,0,0,0,0,0,0,0,0,0,0,0,0,0,0,0,0,0,0,482015405021,130000.0,29.84896593006684,-95.6264181682547,160,3,5,5,5
1437,1502,1503,18,7,18,5,13,13,12,1,0,0,0,0,0,16,5,11,11,10,1,0,0,0,0,0,7,7,0,482015405022,125300.0,29.83935493125057,-95.63006026345911,151,3,4,6,6
1438,1503,1504,45,15,45,9,36,36,23,13,0,0,0,0,0,34,7,27,27,19,8,0,0,0,0,0,15,15,0,482015406011,149900.0,29.854641586322906,-95.6242931512918,153,3,6,8,4
1439,1504,1505,0,0,0,0,0,0,0,0,0,0,0,0,0,0,0,0,0,0,0,0,0,0,0,0,0,0,0,482015406012,118100.0,29.867123984569048,-95.64369615116269,103,1,4,3,2
1440,1505,1506,138,48,138,75,63,60,21,31,2,6,0,0,3,86,50,36,36,11,18,2,5,0,0,0,48,39,9,482015406021,131800.0,29.874425413783165,-95.64337418826383,99,1,4,3,3
1441,1506,1507,0,0,0,0,0,0,0,0,0,0,0,0,0,0,0,0,0,0,0,0,0,0,0,0,0,0,0,482015407001,383500.0,29.84240817519389,-95.6156601234224,163,3,6,5,5
1442,1509,1510,0,0,0,0,0,0,0,0,0,0,0,0,0,0,0,0,0,0,0,0,0,0,0,0,0,0,0,482015408001,91300.0,29.887353728442,-95.62065753961976,110,2,6,4,4
1443,1511,1512,0,0,0,0,0,0,0,0,0,0,0,0,0,0,0,0,0,0,0,0,0,0,0,0,0,0,0,482015408003,103800.0,29.8814359203762,-95.61879208843114,110,2,6,4,4
1444,1512,1513,2,2,2,0,2,2,0,1,1,0,0,0,0,2,0,2,2,0,1,1,0,0,0,0,2,2,0,482015409011,191600.0,29.89009926794483,-95.62081542420812,111,2,6,4,4
1445,1513,1514,0,0,0,0,0,0,0,0,0,0,0,0,0,0,0,0,0,0,0,0,0,0,0,0,0,0,0,482015409022,139900.0,29.90804935508641,-95.62047742905465,120,3,6,5,4
1446,1514,1515,0,0,0,0,0,0,0,0,0,0,0,0,0,0,0,0,0,0,0,0,0,0,0,0,0,0,0,482015409023,166800.0,29.883172873830425,-95.64160838371512,102,1,4,3,3
1447,1515,1516,554,291,554,92,462,457,266,138,5,48,0,0,5,433,63,370,367,222,104,5,36,0,0,3,291,281,10,482015410011,185400.0,29.922300880588157,-95.63114446905684,110,3,5,5,3
1448,1516,1517,0,0,0,0,0,0,0,0,0,0,0,0,0,0,0,0,0,0,0,0,0,0,0,0,0,0,0,482015410022,193300.0,29.945407985502808,-95.66318614944235,109,2,2,4,4
1449,1517,1518,0,0,0,0,0,0,0,0,0,0,0,0,0,0,0,0,0,0,0,0,0,0,0,0,0,0,0,482015412031,189200.0,29.880899475830635,-95.64697628087194,103,1,4,3,3
1450,1518,1519,656,184,656,346,310,306,50,109,1,136,0,10,4,431,223,208,205,39,63,1,97,0,5,3,184,178,6,482015413002,129400.0,29.876139739270343,-95.65218523033776,99,1,3,3,3
1451,1519,1520,544,144,544,268,276,266,92,101,0,73,0,0,10,329,153,176,171,62,57,0,52,0,0,5,144,141,3,482015413003,111400.0,29.867748409869083,-95.65039524756124,103,1,3,3,2
1452,1520,1521,2886,1191,2886,1216,1670,1634,849,464,8,311,2,0,36,2043,779,1264,1245,679,333,5,226,2,0,19,1191,999,192,482015414001,136800.0,29.86182605959703,-95.64715996491556,109,1,4,3,4
1453,1521,1522,0,0,0,0,0,0,0,0,0,0,0,0,0,0,0,0,0,0,0,0,0,0,0,0,0,0,0,482015416011,159700.0,29.83117567449108,-95.6898959165765,174,2,1,4,7
1454,1524,1525,2455,1222,2455,860,1595,1523,883,541,6,85,0,8,72,1812,566,1246,1200,740,379,6,70,0,5,46,1222,1113,109,482015417001,114100.0,29.79719982945453,-95.67229240375364,168,2,2,5,8
1455,1525,1526,421,209,421,292,129,128,56,52,0,16,0,4,1,312,209,103,103,50,40,0,10,0,3,0,209,188,21,482015417002,158300.0,29.813151924457397,-95.65897595901662,170,1,2,4,8
1456,1526,1527,2172,1356,2172,493,1679,1630,857,490,2,268,7,6,49,1816,379,1437,1405,768,407,2,218,6,4,32,1356,1185,171,482015417003,,29.788351107557578,-95.66621186508026,148,2,2,5,7
1457,1529,1530,0,0,0,0,0,0,0,0,0,0,0,0,0,0,0,0,0,0,0,0,0,0,0,0,0,0,0,482015419001,120300.0,29.83106415061861,-95.69446010584244,171,3,1,4,7
1458,1530,1531,0,0,0,0,0,0,0,0,0,0,0,0,0,0,0,0,0,0,0,0,0,0,0,0,0,0,0,482015419002,163700.0,29.80284493615084,-95.69505000714892,161,3,3,4,8
1459,1531,1532,0,0,0,0,0,0,0,0,0,0,0,0,0,0,0,0,0,0,0,0,0,0,0,0,0,0,0,482015420001,134200.0,29.83110389641562,-95.71369878633774,166,3,1,5,7
1460,1533,1534,0,0,0,0,0,0,0,0,0,0,0,0,0,0,0,0,0,0,0,0,0,0,0,0,0,0,0,482015421012,126800.0,29.831223403748435,-95.70932685521706,168,3,1,5,7
1461,1534,1535,0,0,0,0,0,0,0,0,0,0,0,0,0,0,0,0,0,0,0,0,0,0,0,0,0,0,0,482015422001,130300.0,29.83155943192258,-95.73858686661808,144,2,2,5,6
1462,1535,1536,0,0,0,0,0,0,0,0,0,0,0,0,0,0,0,0,0,0,0,0,0,0,0,0,0,0,0,482015423012,123800.0,29.831422024984885,-95.73916902867676,144,2,2,5,7
1463,1536,1537,0,0,0,0,0,0,0,0,0,0,0,0,0,0,0,0,0,0,0,0,0,0,0,0,0,0,0,482015423013,142200.0,29.83111577190871,-95.72331602430246,164,2,1,5,7
1464,1540,1541,0,0,0,0,0,0,0,0,0,0,0,0,0,0,0,0,0,0,0,0,0,0,0,0,0,0,0,482015424003,94700.0,29.78773396316533,-95.7272938973492,141,2,3,5,6
1465,1541,1542,16,7,16,2,14,13,8,3,0,2,0,0,1,12,2,10,10,7,3,0,0,0,0,0,7,6,1,482015425001,164000.0,29.79196805526158,-95.7651513327748,141,2,3,5,8
1466,1542,1543,5,1,5,0,5,0,0,0,0,0,0,0,5,4,0,4,0,0,0,0,0,0,0,4,1,1,0,482015426001,136900.0,29.791484180760595,-95.7803167283592,135,2,3,4,8
1467,1543,1544,0,0,0,0,0,0,0,0,0,0,0,0,0,0,0,0,0,0,0,0,0,0,0,0,0,0,0,482015429003,115300.0,29.84304755112626,-95.79277755244794,97,2,1,3,6
1468,1545,1546,106,92,106,11,95,93,50,22,0,19,0,2,2,64,8,56,56,32,13,0,9,0,2,0,92,30,62,482015430022,238200.0,29.968155738363325,-95.69701458936272,46,1,1,2,2
1469,1547,1548,2579,1081,2579,1005,1574,1553,1194,204,2,147,1,5,21,1917,650,1267,1256,1006,129,2,116,1,2,11,1081,965,116,482015432001,157100.0,29.79494953012455,-95.5716521469474,197,2,3,5,14
1470,1548,1549,1746,982,1746,336,1410,1388,777,116,3,491,1,0,22,1455,271,1184,1166,660,90,3,412,1,0,18,982,849,133,482015432002,235500.0,29.81034349638027,-95.61283306107596,156,2,3,5,9
1471,1549,1550,1599,713,1599,860,739,714,507,159,0,47,0,1,25,1113,539,574,564,435,87,0,41,0,1,10,713,509,204,482015432003,138300.0,29.80198632318518,-95.57658220973552,182,2,4,5,14
1472,1550,1551,2011,1103,2011,503,1508,1464,56,1379,4,21,0,4,44,1285,306,979,945,49,875,4,14,0,3,34,1103,798,305,482015501001,,29.94332282598149,-95.42827090127076,58,3,2,1,0
1473,1552,1553,2168,1006,2168,793,1375,1331,85,1223,2,15,1,5,44,1452,505,947,923,71,835,2,11,1,3,24,1006,868,138,482015502001,103800.0,29.961388044659053,-95.43080341610622,66,3,2,6,0
1474,1553,1554,1557,818,1557,471,1086,1047,62,970,2,13,0,0,39,982,288,694,666,49,605,1,11,0,0,28,818,600,218,482015502002,,29.961793951478104,-95.42331823810824,69,3,1,6,0
1475,1555,1556,5,2,5,0,5,5,0,5,0,0,0,0,0,5,0,5,5,0,5,0,0,0,0,0,2,2,0,482015503013,,29.98108087109564,-95.42502032159268,69,3,2,6,0
1476,1557,1558,688,258,688,472,216,210,53,119,0,36,0,2,6,470,307,163,161,37,92,0,30,0,2,2,258,228,30,482015503023,66900.0,30.00658336342717,-95.45798310587574,64,2,2,6,2
1477,1559,1560,455,289,455,206,249,238,30,194,0,13,1,0,11,337,152,185,177,25,141,0,11,0,0,8,289,203,86,482015504011,69600.0,30.001058422807223,-95.46806569684368,74,2,2,8,1
1478,1560,1561,128,159,128,39,89,89,16,72,0,1,0,0,0,88,24,64,64,14,49,0,1,0,0,0,159,58,101,482015504021,127500.0,29.9666374061108,-95.43323799935342,66,3,3,6,0
1479,1562,1563,982,600,982,338,644,633,74,477,0,77,1,4,11,785,256,529,519,71,383,0,64,1,0,10,600,542,58,482015505002,112300.0,29.943683041595463,-95.44530209438808,61,3,2,1,0
1480,1563,1564,0,0,0,0,0,0,0,0,0,0,0,0,0,0,0,0,0,0,0,0,0,0,0,0,0,0,0,482015506031,93600.0,29.95216561508555,-95.4704976996363,87,3,3,8,1
1481,1564,1565,0,0,0,0,0,0,0,0,0,0,0,0,0,0,0,0,0,0,0,0,0,0,0,0,0,0,0,482015506032,98100.0,29.961550939842247,-95.47759474893051,80,3,3,9,1
1482,1565,1566,0,0,0,0,0,0,0,0,0,0,0,0,0,0,0,0,0,0,0,0,0,0,0,0,0,0,0,482015506033,107300.0,29.95702988351552,-95.47434635604894,85,3,3,8,1
1483,1566,1567,0,0,0,0,0,0,0,0,0,0,0,0,0,0,0,0,0,0,0,0,0,0,0,0,0,0,0,482015507001,99800.0,29.947555344875205,-95.52827662387354,90,2,5,7,2
1484,1567,1568,0,0,0,0,0,0,0,0,0,0,0,0,0,0,0,0,0,0,0,0,0,0,0,0,0,0,0,482015508001,96500.0,29.957158967219986,-95.47544846155355,85,3,3,8,1
1485,1568,1569,0,0,0,0,0,0,0,0,0,0,0,0,0,0,0,0,0,0,0,0,0,0,0,0,0,0,0,482015508002,100100.0,29.949984399054603,-95.46969151905532,86,3,3,5,1
1486,1569,1570,19,5,19,4,15,14,0,0,0,14,0,0,1,13,3,10,10,0,0,0,10,0,0,0,5,4,1,482015509002,125000.0,29.966440456846765,-95.48426026852046,83,3,4,10,1
1487,1571,1572,176,52,176,142,34,34,3,28,0,2,0,1,0,107,83,24,24,3,18,0,2,0,1,0,52,45,7,482015510001,92400.0,29.973792518811504,-95.48898398968028,85,3,4,10,1
1488,1572,1573,0,0,0,0,0,0,0,0,0,0,0,0,0,0,0,0,0,0,0,0,0,0,0,0,0,0,0,482015511002,96300.0,29.967761184509204,-95.48305503111028,83,3,4,10,1
1489,1574,1575,0,0,0,0,0,0,0,0,0,0,0,0,0,0,0,0,0,0,0,0,0,0,0,0,0,0,0,482015511004,142100.0,29.97520002157482,-95.48872973936116,84,3,4,10,1
1490,1575,1576,4,3,4,0,4,4,0,1,0,3,0,0,0,4,0,4,4,0,1,0,3,0,0,0,3,3,0,482015512001,131400.0,29.98395033347972,-95.4994470563757,84,3,2,10,2
1491,1576,1577,0,0,0,0,0,0,0,0,0,0,0,0,0,0,0,0,0,0,0,0,0,0,0,0,0,0,0,482015512002,140000.0,29.97365422209065,-95.4946033111545,84,3,3,10,1
1492,1577,1578,0,0,0,0,0,0,0,0,0,0,0,0,0,0,0,0,0,0,0,0,0,0,0,0,0,0,0,482015512004,158300.0,29.98018284931884,-95.5100158613229,90,1,4,12,2
1493,1578,1579,380,189,380,198,182,179,77,89,1,12,0,0,3,277,140,137,135,59,67,1,8,0,0,2,189,168,21,482015514001,146400.0,29.97817614583132,-95.51370527653567,85,1,4,12,2
1494,1579,1580,369,266,369,144,225,218,80,107,0,30,0,1,7,305,109,196,190,70,91,0,28,0,1,6,266,204,62,482015514003,157200.0,29.96003386109544,-95.53756908920896,100,2,5,6,3
1495,1580,1581,1091,708,1091,286,805,780,366,257,2,154,0,1,25,943,232,711,694,348,217,2,127,0,0,17,708,636,72,482015515001,61400.0,29.95372367212951,-95.5455824646601,107,2,5,7,3
1496,1582,1583,4,1,4,0,4,4,0,0,0,4,0,0,0,4,0,4,4,0,0,0,4,0,0,0,1,1,0,482015516001,127200.0,29.93157016736348,-95.58310822674882,128,2,5,7,3
1497,1583,1584,5,2,5,5,0,0,0,0,0,0,0,0,0,2,2,0,0,0,0,0,0,0,0,0,2,1,1,482015516002,111000.0,29.932304121902323,-95.56894161229634,127,3,5,7,3
1498,1584,1585,0,0,0,0,0,0,0,0,0,0,0,0,0,0,0,0,0,0,0,0,0,0,0,0,0,0,0,482015516003,105900.0,29.92966365743204,-95.56488404225507,129,3,5,7,3
1499,1585,1586,0,0,0,0,0,0,0,0,0,0,0,0,0,0,0,0,0,0,0,0,0,0,0,0,0,0,0,482015518001,177300.0,29.88004129141335,-95.56967370655664,102,3,4,4,4
1500,1587,1588,561,290,561,150,411,400,264,105,3,28,0,0,11,425,94,331,325,216,85,3,21,0,0,6,290,268,22,482015520021,176000.0,29.914167616821672,-95.61089453563837,122,3,6,5,3
1501,1588,1589,577,312,577,140,437,416,144,244,0,28,0,0,21,418,87,331,320,119,183,0,18,0,0,11,312,246,66,482015521011,118600.0,29.920411463902585,-95.62044929282304,124,3,6,6,3
1502,1589,1590,1,1,1,0,1,1,1,0,0,0,0,0,0,1,0,1,1,1,0,0,0,0,0,0,1,1,0,482015521031,142200.0,29.931600376907703,-95.62832671760884,123,3,5,7,5
1503,1590,1591,0,0,0,0,0,0,0,0,0,0,0,0,0,0,0,0,0,0,0,0,0,0,0,0,0,0,0,482015521032,115200.0,29.945348100428355,-95.62722099050036,120,2,5,7,5
1504,1591,1592,2,1,2,2,0,0,0,0,0,0,0,0,0,1,1,0,0,0,0,0,0,0,0,0,1,1,0,482015522001,105000.0,29.94529898587386,-95.62987911097576,116,2,5,6,5
1505,1593,1594,5,2,5,5,0,0,0,0,0,0,0,0,0,3,3,0,0,0,0,0,0,0,0,0,2,2,0,482015522003,108400.0,29.93316598992893,-95.64384182127468,122,2,4,5,4
1506,1594,1595,14,17,14,0,14,13,13,0,0,0,0,0,1,13,0,13,13,13,0,0,0,0,0,0,17,10,7,482015523011,143000.0,29.94975303506073,-95.62916295439328,114,2,5,6,4
1507,1595,1596,0,0,0,0,0,0,0,0,0,0,0,0,0,0,0,0,0,0,0,0,0,0,0,0,0,0,0,482015524001,153500.0,29.939618972725214,-95.5854806755302,125,2,5,7,3
1508,1597,1598,1049,400,1049,348,701,645,181,415,0,47,2,0,56,634,186,448,430,137,256,0,35,2,0,18,400,378,22,482015524003,109500.0,29.925882735970557,-95.59926019917204,131,2,5,6,3
1509,1598,1599,0,0,0,0,0,0,0,0,0,0,0,0,0,0,0,0,0,0,0,0,0,0,0,0,0,0,0,482015525001,117800.0,29.954377232909607,-95.55688095643134,114,2,5,7,3
1510,1599,1600,3,1,3,0,3,3,0,0,0,3,0,0,0,3,0,3,3,0,0,0,3,0,0,0,1,1,0,482015525002,140000.0,29.937159295683568,-95.58066531618812,125,3,5,7,3
1511,1600,1601,2685,1311,2685,1022,1663,1601,645,835,6,108,6,1,62,1967,704,1263,1229,564,566,6,87,5,1,34,1311,1190,121,482015526011,152700.0,29.96191413136866,-95.55659113789125,105,2,5,7,3
1512,1601,1602,26,17,26,1,25,25,19,3,0,3,0,0,0,22,1,21,21,15,3,0,3,0,0,0,17,17,0,482015526021,183700.0,29.973429421457304,-95.56280556098076,102,2,4,9,3
1513,1602,1603,312,160,312,164,148,144,68,60,0,15,0,1,4,206,96,110,108,58,36,0,13,0,1,2,160,121,39,482015527001,147400.0,29.97820760147639,-95.56282701188816,98,1,4,9,3
1514,1603,1604,2174,1726,2174,370,1804,1780,992,366,9,411,0,2,24,1863,284,1579,1564,947,283,6,326,0,2,15,1726,1385,341,482015527002,213700.0,29.967269210030885,-95.5459019961592,100,2,5,8,3
1515,1604,1605,0,0,0,0,0,0,0,0,0,0,0,0,0,0,0,0,0,0,0,0,0,0,0,0,0,0,0,482015527003,153700.0,29.966080967560096,-95.55423383975312,105,2,5,8,3
1516,1605,1606,0,0,0,0,0,0,0,0,0,0,0,0,0,0,0,0,0,0,0,0,0,0,0,0,0,0,0,482015528002,276100.0,29.977920694658103,-95.51702820645389,83,1,4,12,2
1517,1606,1607,509,275,509,93,416,393,194,167,1,31,0,0,23,379,66,313,298,161,110,1,26,0,0,15,275,240,35,482015528003,225200.0,29.971229421164285,-95.53536237152184,96,2,4,8,2
1518,1607,1608,0,0,0,0,0,0,0,0,0,0,0,0,0,0,0,0,0,0,0,0,0,0,0,0,0,0,0,482015528005,195800.0,29.977944059845065,-95.54030649009894,97,1,4,8,3
1519,1608,1609,0,0,0,0,0,0,0,0,0,0,0,0,0,0,0,0,0,0,0,0,0,0,0,0,0,0,0,482015529002,75300.0,29.98998849117048,-95.51146587397945,87,1,3,12,2
1520,1609,1610,0,0,0,0,0,0,0,0,0,0,0,0,0,0,0,0,0,0,0,0,0,0,0,0,0,0,0,482015529003,177800.0,29.987568115286862,-95.5012260745065,83,2,2,10,2
1521,1610,1611,329,288,329,89,240,235,124,100,1,9,0,1,5,263,65,198,195,109,76,1,9,0,0,3,288,178,110,482015529004,190200.0,29.984646333141487,-95.5108398394295,87,1,3,12,2
1522,1611,1612,3,6,3,1,2,2,2,0,0,0,0,0,0,3,1,2,2,2,0,0,0,0,0,0,6,2,4,482015530012,164900.0,29.99789481743776,-95.48371076561496,79,3,2,10,1
1523,1613,1614,108,46,108,12,96,95,71,5,0,19,0,0,1,95,7,88,88,67,5,0,16,0,0,0,46,43,3,482015530021,176700.0,30.010061391934656,-95.4763376231052,74,2,2,8,2
1524,1614,1615,25,12,25,0,25,25,23,0,1,1,0,0,0,24,0,24,24,22,0,1,1,0,0,0,12,12,0,482015530022,236100.0,30.003434818838304,-95.47868377290482,73,2,2,9,2
1525,1615,1616,0,0,0,0,0,0,0,0,0,0,0,0,0,0,0,0,0,0,0,0,0,0,0,0,0,0,0,482015531002,139100.0,30.013228482924475,-95.45258369559676,66,2,2,7,3
1526,1616,1617,6,2,6,5,1,1,1,0,0,0,0,0,0,6,5,1,1,1,0,0,0,0,0,0,2,2,0,482015531003,148000.0,30.010232788438703,-95.46287838872914,74,2,2,7,2
1527,1617,1618,0,0,0,0,0,0,0,0,0,0,0,0,0,0,0,0,0,0,0,0,0,0,0,0,0,0,0,482015531004,182000.0,30.015204594545693,-95.46921030600426,90,2,2,9,4
1528,1618,1619,0,0,0,0,0,0,0,0,0,0,0,0,0,0,0,0,0,0,0,0,0,0,0,0,0,0,0,482015532001,134100.0,30.015986321120774,-95.44676644463398,74,2,2,6,3
1529,1621,1622,529,171,529,447,82,78,44,28,0,3,2,1,4,363,304,59,57,31,22,0,2,2,0,2,171,163,8,482015532004,311100.0,30.02060283454591,-95.44127890973564,75,2,2,6,3
1530,1622,1623,0,0,0,0,0,0,0,0,0,0,0,0,0,0,0,0,0,0,0,0,0,0,0,0,0,0,0,482015533001,,30.026336380196824,-95.43700738650077,55,2,2,6,2
1531,1624,1625,30,16,30,9,21,21,15,2,0,4,0,0,0,24,5,19,19,13,2,0,4,0,0,0,16,12,4,482015534011,152900.0,30.04821462259343,-95.4328294645184,55,1,2,6,2
1532,1625,1626,0,0,0,0,0,0,0,0,0,0,0,0,0,0,0,0,0,0,0,0,0,0,0,0,0,0,0,482015534021,146000.0,30.055195845277627,-95.43706476021306,50,1,2,6,2
1533,1626,1627,3,1,3,3,0,0,0,0,0,0,0,0,0,2,2,0,0,0,0,0,0,0,0,0,1,1,0,482015534031,190000.0,30.06203015773028,-95.43556071384782,41,1,2,6,2
1534,1627,1628,20,5,20,6,14,14,9,5,0,0,0,0,0,14,5,9,9,6,3,0,0,0,0,0,5,5,0,482015542001,121800.0,30.00149630986424,-95.5806503827682,70,0,3,6,3
1535,1628,1629,0,0,0,0,0,0,0,0,0,0,0,0,0,0,0,0,0,0,0,0,0,0,0,0,0,0,0,482015543012,173400.0,29.996526426286625,-95.60417926105572,69,1,2,9,4
1536,1629,1630,0,0,0,0,0,0,0,0,0,0,0,0,0,0,0,0,0,0,0,0,0,0,0,0,0,0,0,482015543013,145700.0,29.994387187901072,-95.5801190178931,77,1,3,9,3
1537,1630,1631,0,0,0,0,0,0,0,0,0,0,0,0,0,0,0,0,0,0,0,0,0,0,0,0,0,0,0,482015544012,260900.0,29.95968656792768,-95.6826406761196,57,1,1,2,2
1538,1632,1633,3,3,3,0,3,3,3,0,0,0,0,0,0,3,0,3,3,3,0,0,0,0,0,0,3,2,1,482015544031,153700.0,29.98966140527181,-95.7126483597957,21,1,0,2,1
1539,1633,1634,0,0,0,0,0,0,0,0,0,0,0,0,0,0,0,0,0,0,0,0,0,0,0,0,0,0,0,482015545022,256800.0,29.994444394816856,-95.62425255101442,66,1,2,9,3
1540,1634,1635,0,0,0,0,0,0,0,0,0,0,0,0,0,0,0,0,0,0,0,0,0,0,0,0,0,0,0,482015546001,192500.0,30.005927355230774,-95.60890704297474,62,1,2,6,4
1541,1635,1636,0,1,0,0,0,0,0,0,0,0,0,0,0,0,0,0,0,0,0,0,0,0,0,0,1,0,1,482015546002,244900.0,29.99563635336096,-95.61930678579854,70,1,2,9,3
1542,1636,1637,0,0,0,0,0,0,0,0,0,0,0,0,0,0,0,0,0,0,0,0,0,0,0,0,0,0,0,482015547001,188800.0,30.00464353485245,-95.58637105864116,69,0,3,6,4
1543,1637,1638,2,1,2,0,2,0,0,0,0,0,0,0,2,2,0,2,0,0,0,0,0,0,0,2,1,1,0,482015547002,210900.0,29.999297057007663,-95.60902369910376,64,1,2,8,4
1544,1638,1639,0,0,0,0,0,0,0,0,0,0,0,0,0,0,0,0,0,0,0,0,0,0,0,0,0,0,0,482015548011,142900.0,30.045740140354734,-95.60285701438848,64,0,3,7,4
1545,1639,1640,0,0,0,0,0,0,0,0,0,0,0,0,0,0,0,0,0,0,0,0,0,0,0,0,0,0,0,482015548021,239600.0,30.063994066314464,-95.57043184521883,62,0,3,5,6
1546,1640,1641,0,0,0,0,0,0,0,0,0,0,0,0,0,0,0,0,0,0,0,0,0,0,0,0,0,0,0,482015549011,150900.0,30.08647048447792,-95.55488115750109,38,0,1,4,4
1547,1641,1642,0,0,0,0,0,0,0,0,0,0,0,0,0,0,0,0,0,0,0,0,0,0,0,0,0,0,0,482015549012,111600.0,30.094636927510034,-95.544809124471,37,0,2,4,4
1548,1644,1645,0,0,0,0,0,0,0,0,0,0,0,0,0,0,0,0,0,0,0,0,0,0,0,0,0,0,0,482015556001,237700.0,30.033536368828948,-95.72588424335288,12,1,0,1,0
1549,1646,1647,0,0,0,0,0,0,0,0,0,0,0,0,0,0,0,0,0,0,0,0,0,0,0,0,0,0,0,482015557012,147700.0,29.98693810737781,-95.72559266406358,19,1,0,1,1
1550,1647,1648,0,0,0,0,0,0,0,0,0,0,0,0,0,0,0,0,0,0,0,0,0,0,0,0,0,0,0,482015557021,193900.0,30.00094455217494,-95.76531323821936,12,1,0,1,0
1551,1648,1649,0,0,0,0,0,0,0,0,0,0,0,0,0,0,0,0,0,0,0,0,0,0,0,0,0,0,0,482015560001,155100.0,30.081625798419005,-95.889812975191,1,0,0,0,0
1552,1651,1652,33,17,33,9,24,23,11,12,0,0,0,0,1,24,4,20,19,11,8,0,0,0,0,1,17,15,2,482019800001,,29.64615965324325,-95.27726667441392,60,5,4,3,4
1553,1652,1653,603,254,603,157,446,439,53,373,2,7,4,0,7,351,89,262,258,40,207,2,6,3,0,4,254,224,30,482019801001,,29.98887480132579,-95.340102925823,78,3,4,4,1
1554,1653,1654,0,0,0,0,0,0,0,0,0,0,0,0,0,0,0,0,0,0,0,0,0,0,0,0,0,0,0,483396920021,553400.0,30.0365334678738,-95.28033261979476,79,1,2,6,3
1555,1654,1655,2261,1318,2261,416,1845,1801,1310,338,19,124,8,2,44,1946,325,1621,1588,1184,271,14,111,6,2,33,1318,1185,133,483396923004,113500.0,30.05325545272736,-95.25792375884564,89,2,2,6,5
1556,1655,1656,18,13,18,2,16,16,16,0,0,0,0,0,0,16,1,15,15,15,0,0,0,0,0,0,13,8,5,483396923005,214500.0,30.06987510631153,-95.2568045186896,74,2,3,5,6
